VOLTAIRE	VOLTAIRE
CANDIDE	CANDIDE
AZ OPTIMISTA VILÁGNÉZET	CHÀNG NGÂY THƠ
TARTALOM	Mục lục
ELSŐ FEJEZET. Hogyan nevelték Candide-ot egy gyönyörü kastélyban és hogyan kergették ki onnan.	Chương I CHÀNG NGÂY THƠ ĐƯỢC NUÔI NẤNG TRONG MỘT TÒA LÂU ĐÀI TỐT ĐẸP
MÁSODIK FEJEZET. Mi történt Candide-dal a bolgárok között?	Chương II CHÀNG NGÂY THƠ SỐNG CHUNG VỚI NGƯỜI BẢO GIA LỢI
HARMADIK FEJEZET. Hogyan szabadult meg Candide a bolgároktól és mily sorsra jutott?	Chương III CHÀNG NGÂY THƠ THOÁT KHỎI TAY NGƯỜI BẢO GIA LỢI
NEGYEDIK FEJEZET. Hogyan találkozott Candide hajdani filozófia-tanitójával, Pangloss doktorral s mi lett az utóbbi sorsa?	Chương IV CHÀNG NGÂY THƠ GẶP LẠI THẦY CŨ, TRIẾT GIA PANGLOSS
ÖTÖDIK FEJEZET. Vihar, hajótörés, földrengés; mi történt Pangloss doktorral, Candide-dal és az anabaptista Jacques-kal?	Chương V BÃO TỐ, ĐẮM TÀU, ĐỘNG ĐẤT, KHIẾN CHO PANGLOSS, JACQUES VÀ CHÀNG NGÂY THƠ RA SAO
HATODIK FEJEZET. Ünnepélyesen máglyát raknak, hogy eretnek-égetéssel akadályozzák meg a földrengést; Candide-ot megbotozzák.	Chương VI NGƯỜI TA TIẾN HÀNH VỤ THIÊU SỐNG HAY HO NHƯ THẾ NÀO ĐỂ NGĂN ĐỘNG ĐẤT, VÀ CHÀNG NGÂY THƠ ĐÃ BỊ ĐÒN ĐÍT RA SAO
HETEDIK FEJEZET. Hogyan gondoskodik Candide-ról egy öreg asszony; hogyan találja fel kedvesét.	Chương VII CHÀNG NGÂY THƠ ĐƯỢC BÀ GIÀ CHĂM SÓC VÀ GẶP LẠI NHỮNG NGƯỜI CHÀNG YÊU QUÝ
NYOLCADIK FEJEZET. Kunigunda története.	Chương VIII CÂU CHUYỆN VỀ CÔ CUNÉGONDE
KILENCEDIK FEJEZET. Mi történt Kunigundával, Candide-dal, a nagy inkvizitorral és a zsidóval?	Chương IX CHÀNG NGÂY THƠ GIẾT MỘT LÚC HAI MẠNG NGƯỜI
TIZENEGYEDIK FEJEZET. Az öreg asszony története.	Chương XI CU CHUYỆM CỦA BÀ GIÀ
TIZENKETTEDIK FEJEZET. Az öreg asszony tovább meséli viszontagságait.	Chương XII CÂU CHUYỆN TIẾP VỀ NHỮNG ĐAU KHỔ CỦA BÀ GIÀ
TIZENHARMADIK FEJEZET. Hogyan kellett Candide-nak elválnia a szép Kunigundától és az öreg asszonytól?	Chương XIII CHÀNG NGÂY THƠ BUỘC LÒNG PHẢI CÁCH BIỆT CUNÉGONDE VÀ BÀ GIÀ
TIZENNEGYEDIK FEJEZET. Hogyan fogadták Candide-ot és Cacambot Paraguayban a jezsuiták?	Chương XIV CHÀNG NGÂY THƠ VÀ ĐỒ ĐỆ CACAMBO ĐƯỢC CÁC GIÁO SĨ DÒNG TÊN ĐÓN TIẾP Ở PARAGUAY
TIZENÖTÖDIK FEJEZET. Hogyan ölte meg Candide a kedves Kunigunda bátyját?	Chương XV CHÀNG NGÂY THƠ GIẾT ANH RUỘT CỦA NGƯỜI YÊU
TIZENHATODIK FEJEZET. Milyen kalandjuk volt utasainknak két leánnyal, két majommal és az Oreillons-nevezetű vademberekkel?	Chương XVI CHUYỆN XẢY RA GIỮA HAI THẦY TRÒ KHI GẶP HAI THIẾU NỮ, HAI CON KHỈ VÀ ĐÁM NGƯỜI RỢ OREILLONS
TIZENHETEDIK FEJEZET. Candide és lakája Eldorádóba érkeznek; mit látnak ott?	Chương XVII CHÀNG NGÂY THƠ VÀ THUỘC HẠ ĐẾN XỨ ELDORADO KỲ LẠ
TIZENNYOLCADIK FEJEZET. Mit láttak Eldorádóban?	Chương XVIII THẦY TRÒ CACAMBO THẤY GÌ Ở XỨ ELDORADO
TIZENKILENCEDIK FEJEZET. Mi történt velök Surinamban s hogyan kötött Candide ismeretséget Martinnal?	Chương XIX HAI NGƯỜI ĐẾN SURINAM; CHÀNG NGÂY THƠ LÀM QUEN VỚI MARTIN
HUSZADIK FEJEZET. Mi történt Candide-dal és Martinnal a tengeren?	Chương XX ĐIỀU GÌ XẢY RA TRÊN BIỂN VỚI CHÀNG NGÂY THƠ VÀ MARTIN
HUSZONEGYEDIK FEJEZET. Candide és Martin Franciaország partjai felé közelednek és folytatják az eszmecserét.	Chương XXI TÀU TỚI GẦN BỜ BIỂN PHÁP, HAI NGƯỜI VẪN ĐÀM LUẬN
HUSZONKETTEDIK FEJEZET. Mi történt Candide-dal és Martinnal Franciaországban?	Chương XXII BIẾN CỐ XẢY ĐẾN CHO HAI NGƯỜI Ở NƯỚC PHÁP
HUSZONHARMADIK FEJEZET. Candide és Martin angol partokhoz érkeznek; mit látnak ott?	Chương XXIII CHÀNG NGÂY THƠ VÀ MARTIN TỚI MIỀN DUYÊN HẢI ANH RỒI BỎ ĐI NGAY
HUSZONNEGYEDIK FEJEZET. Raquette és Giroflée barát története.	Chương XIV GẶP LẠI CÔ PAQUETTE TRONG TAY MỘT TU SĨ
HUSZONÖTÖDIK FEJEZET. Látogatás Pococuranté őnagyméltóságánál, a velencei nemesnél.	Chương XXV ĐI DU THUYỀN ĐẾN THĂM LÃNH CHÚA POCOCURENTÉ, NHÀ QUÝ TỘC THÀNH VENISE
HUSZONHATODIK FEJEZET. Candide és Martin együtt vacsorálnak hat idegennel; kik ezek az idegenek?	Chương XXVI CHÀNG NGÂY THƠ VÀ MARTIN DÙNG BỮA VỚI SÁU NGƯỜI NGOẠI QUỐC
HUSZONHETEDIK FEJEZET. Candide Konstantinápolyba utazik.	Chương XXVII TRONG CUỘC HÀNH TRÌNH TỚI CONSTANTINOPLE, CHÀNG NGÂY THƠ GẶP LẠI NAM TƯỚC VÀ PANGLOSS
HUSZONNYOLCADIK FEJEZET. Mi történt Candide-dal, Kunigundával, Panglossal, Martinnal és a többivel?	Chương XXVIII BIỂN CỐ XẢY RA CHO CHÀNG NGÂY THƠ, CUNÉGONDE, MARTIN, PANGLOSS…
HUSZONKILENCEDIK FEJEZET. Hogyan talált a meg Candide Kunigundát és az öreg asszonyt?	Chương XXIX CHÀNG NGÂY THƠ TÁI NGỘ CUNÉGONDE
HARMINCADIK FEJEZET. Befejezés.	Chương XXX KẾT LUẬN
ELSŐ FEJEZET.	Chương I
Hogyan nevelték Candide-ot egy gyönyörü kastélyban és hogyan kergették ki onnan.	CHÀNG NGÂY THƠ ĐƯỢC NUÔI NẤNG TRONG MỘT TÒA LÂU ĐÀI TỐT ĐẸP
Westphaliában, Thunder-ten-tronckh báró ur kastélyában élt egy fiatal ember, kit a természet a legszelidebb erkölcsökkel áldott meg.	Tại vùng Westphalie, có tòa lâu đài của Nam tước Thunder-ten-tronckh; một chàng thanh niên tính tình hiền hậu, hồn nhiên sống trong tòa lâu đài này.
Arcvonásai hiven tükrözték vissza jóságos lelkét.	Bộ diện của chàng phản chiếu tâm hồn chàng.
Elég józan itélőképessége a legegyszerübb szellemmel párosult, és ugy hiszem ezért nevezték Candide1-nak.	Chàng xét đoán việc đời thẳng thắn, với một tinh thần giản dị nhất; vì lý do ấy người ta gọi chàng là "chàng Ngây Thơ".
A ház régi cselédei ugy sejtették, hogy Candide a báró ur nővérének és egy környékbeli derék és tisztességes nemesnek a fia, akihez a kisasszony semmikép sem akart feleségül menni, mert a szerencsétlen férfi csak hetvenegy családfát tudott felmutatni s családfájának többi ágazatát elpusztitották az idő viharai.	Những gia nhân hầu hạ trong nhà từ lâu năm nghi ngờ chàng là con của bà em nam tước với một người trưởng giả cùng xóm, sống lương thiện; nhưng bà không muốn cưới ông trưởng giả này vì ông chỉ có thể minh chứng được 71 chi tộc của ông, còn bao nhiêu trong tờ tông chi thì bị thất lạc vì sự tàn nhẫn của thời gian.
A báró ur Westphalia leghatalmasabb urai közé számitott, mert kastélyának egy kapuja és néhány ablaka volt; sőt a nagy termet még szőnyeg is ékesitette.	Nam tước là một trong những lãnh chúa thế lực nhất vùng Westphalie; lâu đài của ông có một cửa lớn và nhiều cửa sổ.
A báróné asszony, ki körülbelül háromszázötven fontot nyomott, már ennek révén is nagy tekintélynek örvendett és még tiszteletre-méltóbbá tette őt az a méltóságos magatartás, mivel a ház ügyeit igazgatta.	Bà nam nước nặng chừng ba trăm năm chục cân Anh, được người ta kính trọng vì thân thể đẫy đà của bà; trong các cuộc tiếp tân của gia đình, bà tỏ ra có tư cách, bà lại càng được tôn trọng hơn.
Leánya, Kunigunda, tizenhét éves, üde arcu, élénk, telt idomu, kivána­tos leány volt.	Con gái bà là Cunégonde mới 17 tuổi, hồng hào, cao lớn, tươi đẹp.
A báró fia pedig minden tekintetben méltónak látszott atyjához.	Con trai của nam tước giống cha về đủ mọi phương diện.
Pangloss,2 a házi tanitó valóságos orákuluma volt a családnak és a kis Candide korához és jelleméhez illő lelkesedéssel hallgatta tanitásait.	Chàng Ngây Thơ tuân theo những lời giáo huấn của ông với một lòng tin tưởng theo tuổi tác của cậu và tính tình cậu.
Pangloss a metafizikai-theologiai-kozmolo-nigologiát tanitotta.	Ông Pangloss vừa dạy các khoa siêu hình-thần-vũ trụ-u-minh học.
"Nyilvánvaló, mondogatta, hogy a dolgok nem lehetnek másformák; mert minden bizonyos célra lévén alkotva, szükségképen a legjobb célra is alkottatott minden.	"Đã có sự chứng minh cho thấy rằng mọi sự kiện đều có một cứu cánh, mọi sự việc đều nhất thiết phải đi đến một cứu cánh hoàn bích hơn.
Candide figyelmesen hallgatta őt és ártatlanul hitt e tanitásoknak; mert Kunigunda kisasszonyt elragadóan szépnek találta, habár sohasem volt bátorsága ezt néki bevallani.	Chàng Ngây Thơ chú ý nghe kỹ những lời giảng thuyết ấy, vì chàng nhận thấy cô Cunégonde đẹp cực kỳ dầu không bao giờ chàng dám khen cô điều ấy.
Meggyőződése szerint azon boldogság után, hogy valaki Thunder-ten-tronckh bárónak születik, a boldogság következő foka Kunigunda kisasszonynak lenni; a harmadik: őt mindennap láthatni, a negyedik: Pangloss mestert hallgatni, ki a környéknek s ebből kifolyólag az egész világnak legnagyobb filozófusa.	Chàng kết luận rằng sau cái diễm phúc được sinh ra là nam tước Thunder-ten-tronckh, đến cái diễm phúc bậc nhì là được sinh ra là cô Cunégonde; kế đến diễm phúc bậc ba là được nhìn thấy cô suốt ngày và sau chót diễm phúc bậc tư là được nghe những lời thuyết giảng của Pangloss tiên sinh, triết gia giỏi nhất trong tỉnh và do đó là triết gia giỏi nhất hoàn cầu.
Midőn Kunigunda egy napon a kastély előtt sétált, azon a kis befásitott helyen, melyet parknak neveztek, a lombok között Pangloss doktort pillantotta meg, amint épen kisérleti fizikából adott órát az édes anyja szobaleányának, egy szép és fogékony kis barna terem­tés­nek.	Một hôm cô Cunégonde đi dạo gần lâu đài, trong một khu rừng nhỏ, nhìn thấy trong bụi rậm, tiến sĩ Pangloss đang dạy một bài học vật lý thử nghiệm cho thị tì hầu phòng của thân mẫu cô, một chị tóc nâu, rất đẹp và rất dễ dạy.
Mivelhogy Kunigunda kisasszony különösen érdeklődött a tudományok iránt, lélegzetét visszafojtva figyelte a többször megismételt kisérleteket, melyeknek véletlenül tanuja lett; világosan látta a doktor részéről az elegendő indokot, a hatásokat meg az okokat, és nagy izgatottsággal, tudni vágyással telten tért vissza, és eszébe ötlött, hogy ő is szolgálhatna elegendő indokul Candide-nak vagy Candide őneki.	Vì cô Cunégonde có nhiều thiên tư về khoa học nên cô đứng yên không thở để quan sát những thử nghiệm lặp đi lặp lại của tiến sĩ mà cô được chứng kiến; cô thấy rõ ràng lý do khiến tiến sĩ làm cuộc thí nghiệm, những hậu quả và những nguyên nhân; cô trở về lòng dao động, óc suy nghĩ rằng cô cũng có ngày trở thành thông thái và thành lý do cho chàng Ngây Thơ trẻ trung; người cũng có thể là lý do của cô.
A kastélyba visszatérve találkozott Candide-dal és elpirult; Candide szintén piros lett.	Trở về lâu đài, cô gặp chàng Ngây Thơ và đỏ mặt thẹn thuồng; chàng Ngây Thơ cũng đỏ mặt.
Kunigunda elfogódott hangon köszöntötte őt és Candide beszélt hozzá anélkül, hogy tudná, mit mond.	Cô chào chàng với một câu nhát gừng và chàng đáp lại bằng câu nói mà chàng không hiểu là mình nói gì.
MÁSODIK FEJEZET.	Chương II
Mi történt Candide-dal a bolgárok között?	CHÀNG NGÂY THƠ SỐNG CHUNG VỚI NGƯỜI BẢO GIA LỢI
Kiüzve a földi paradicsomból, sokáig mendegélt Candide anélkül, hogy tudná hova.	Chàng không ăn bữa chiều, nằm lăn ra ruộng, giữa hai luống cày, trong khi trời đổ tuyết.
- Oh, uram!	- Xin ông chớ quan tâm.
- Csakugyan uraim, ez a magasságom, mondá meg­hajolva.	- Vâng thưa ông đúng là tầm thước của tôi, chàng vừa nói vừa đứng lên thi lễ.
- Ülj le komám az asztalhoz; nem csak a fizetéstől mentünk fel, de azt sem fogjuk tűrni, hogy ilyen fickó pénz szűkében legyen; hiszen az embereknek mindenkor segiteniök kell egymást.	- Vậy thì, thưa ông, mời ông ngồi vào bàn với chúng tôi, không những chúng tôi xin chịu mọi tiền phí tổn, mà còn không bao giờ chúng tôi cho phép một người như ông lại thiếu tiền.
"Nagyon szereted...?	Câu chuyện bắt đầu.
- Oh igen, felelte, nagyon szeretem Kunigunda kisasszonyt.	- Vâng, có. - Tôi yêu tha thiết cô Cunégonde.
- Nem róla van szó, mondá az egyik kékruhás, azt kérdezzük, hogy nagyon szereted-é a bolgár királyt?	- Không, một trong hai người hỏi lại, chúng tôi muốn hỏi ông có yêu tha thiết vua Bảo Gia Lợi không? - Không!
- Dehogy szeretem, hiszen sohasem láttam.	- Tại sao ông không biết Ngài.
- Ugyan ne mondd, pedig ő a legszeretetreméltóbb király, igyunk az egészségére.	Ngài là ông vua khả ái nhất, chúng ta phải nâng ly chúc cho vua trường thọ.
- Kész örömmel, Uraim!" És ivott.	- Tôi rất vui lòng, thưa hai ông.
Ott rászoktatják, hogy jobbra-át, balra-át, vállhoz a puskát, lábhoz a puskát, célozz, lőjj, lépést szaporázz - s végül harmincat kap a fenekére; másnap már jobban végzi a gyakorlatot és csak huszat kap; a következő napon már csak tizet adnak neki és pajtásai ugy nézik, mint valami csodát.	Hôm sau, chàng lại tập, ít vụng về hơn hôm trước và chàng chỉ phải nhận hai mươi gậy thôi; hôm sau nữa người ta chỉ cho chàng có mười gậy và chàng được các chiến hữu coi như một người phi thường.
Candide nagyon elcsodálkozott a történteken és még nem igen értette, hogyan lett hőssé.	Chàng Ngây Thơ rất ngạc nhiên, chẳng hiểu tại sao chàng trở thành một vị anh hùng.
Egy szép tavaszi napon sétára határozta magát s mindég egyenesen előre ment, mert meg volt róla győződve, hogy lábaiknak kedvök szerint való használata ép oly kiváltsága az emberi, mint az állati nemnek.	Trong một ngày mùa xuân tốt trời, chàng đi dạo đầu thẳng và nhìn về phía trước; chàng suy luận rằng đặc ân của loài người và cũng là đặc ân của loài thú, là được tự tiện dùng hai cái chân của mình.
Ám alig tett meg két mértföldet, midőn négy másik, hat láb magas hős utolérte, megkötözte, elhurcolta és tömlöcbevetette.	Chàng đi chưa được hai dặm thì bỗng có bốn vị anh hùng khác, cao sáu bộ, bắt kịp chàng, trói tay chàng đem về phòng giam kín.
Mivel pedig a hadsereg kétezer emberből állott, ez négyezer ütést jelentett számára, amik nyakszirtjétől faráig záporként hullottak rá.	Liên đội gồm có hai nghìn người; thế là chàng phải chịu bốn nghìn roi đánh từ trên cổ xuống tới đít.
Mikor a harmadik futásra került volna a sor, Candide ugy érezte, hogy ezt már nem birja ki s azt a kegyet kérte, legyenek oly irgalmasak s zuzzák szét a fejét.	Vì người ta đang tiến hành lượt thứ ba, chàng đã bị trầy da chảy máu, thấy chịu không nổi nữa bèn xin một ân huệ là bắn bể đầu chàng.
Hajlandók voltak ezt a kegyet megadni; szemeit bekötözik, letérdepeltetik.	Người ta cho chàng được hưởng ân huệ ấy, lấy băng bịt mắt chàng, bắt chàng quỳ gối xuống.
E pillanatban megjelenik a bolgár király és érdeklődik az elitélt büne felől.	Nhằm lúc vua Bảo Gia Lợi vừa đi qua, Ngài hỏi biết được tội trạng của chàng: vua vốn là người tài trí lớn.
Egy derék felcser három hét alatt meggyógyitá Candide-ot a Dioszkoridesz ajánlotta orvosszerekkel.	Một nhà giải phẫu giỏi chữa trị cho chàng lành các vết thương sau ba tuần lễ bằng các phương thuốc cao truyền từ đời Dioscoride.
Már egy kissé behegedtek sebei és már járni is tudott, midőn a bolgár király háborut inditott az arab király ellen.	Các vết thương đã lên da và chàng có thể đi đứng được khi vua Bảo Gia Lợi gây chiến với vua Abares.
HARMADIK FEJEZET.	Chương III
Hogyan szabadult meg Candide a bolgároktól és mily sorsra jutott?	CHÀNG NGÂY THƠ THOÁT KHỎI TAY NGƯỜI BẢO GIA LỢI
Először az ágyuk söpörtek el körülbelül hatezer embert mindkét részről; azután a muskétások szabaditották meg ezt a legjobb világot vagy kilenc-tizezer bitangtól, akik rontották itt a levegőt; a szurony is elegendő oka volt néhány ezer ember halálának.	Những tiếng súng thần công bắn ngã gần sáu nghìn người mỗi bên; kế đến lính pháo thủ hạ hết những binh lính thiện chiến chừng chín, mười ngàn người, thây chất đầy mặt đất, sau đến những lưỡi lê cũng làm cho vài ngàn người bỏ mạng.
Az áldozatok száma jóval tulhaladhatta a harmincezret.	Tất cả lên tới chừng ba vạn nhân mạng.
Candide, aki ugy reszketett, mint egy filozófushoz illik, a legjobb képessége szerint elrejtőzködött a hősi mészárlás alatt.	Chàng Ngây Thơ run rẩy như một nhà triết học, chàng cố sức ẩn núp trong cuộc giết thịt người hùng dũng ấy.
Végül, mialatt a két ellenséges király, kiki a maga táborában, a Te Deum-ot énekeltette, Candide arra határozta magát, hogy máshova megy elmélkedni az okok és okozatok felől.	Sau chót, trong khi vua hai bên cho lệnh hát bài Thánh ca Te Deum trong mỗi trại binh thì chàng Ngây Thơ quyết định đi chỗ khác mà suy luận về nhân với quả.
Candide, amily gyorsan csak tudott, egy másik faluba menekült: ez a bolgároké volt s az arab hősök hasonlóképen bántak el vele.	Chàng Ngây Thơ trốn cho thật mau đến một làng khác; làng này về bên phe Bảo Gia Lợi nên những anh hùng Abares đối xử nó như thế kia.
Mire Hollandiába érkezett, el­fogyott az ennivalója, de mivel hallotta, hogy ebben a boldog országban mindenki gazdag és keresztény, nem kételkedett abban, hogy ép oly jól fognak vele bánni, mint a báró ur kastélyában, mielőtt Kunigunda kisasszony szép szemei miatt kiüzték onnan.	Đã nghe người ta nói rằng dân nước này giàu có và theo đạo Cơ đốc, nên chàng không thể ngờ rằng họ xấu với chàng và tin rằng họ cũng đối xử tốt với chàng như hồi chàng còn ở trong lâu đài của vị nam tước, trước khi bị đuổi đi chỉ vì cặp mắt đẹp của cô Cunégonde.
Alamizsnát kért több előkelő személytől, de valamennyien figyelmeztették arra, hogy ha nem hagy fel a koldulás mesterségével, javitó intézetbe zárják s ott majd megtanulja, hogyan keresse meg a kenyerét:	Chàng chìa tay xin tiền những người có vẻ bệ vệ; tất cả mọi người đều cho chàng hay rằng chàng sẽ bị bắt giam vào trại giáo hoá để dạy chàng sống.
valami jó ügy hozott ide?	- Anh đến đây làm gì?
- Barátom, kérdé a hitszónok, azon a nézeten vagy, hogy a pápa az Antikrisztus?	Bạn có thể tin rằng Đức Giáo hoàng là người chống Thiên Chúa giáo không? - Tôi chưa bao giờ nghe nói điều ấy.
Milyen tulzásba ragadja a nőket a vallásos buzgalom!	Sự ngoan đạo làm các bà quá trớn biết bao.
Egy ember, ki nem volt megkeresztelve, egy Jacques nevü jámbor anabaptista, végig nézte, mily kegyetlen és csufondáros módon bántak el egyik testvérével, egy lelkes, kétlábu, tollat­lan lénnyel; hazavezette otthonába, megfürdette, kenyeret és sört tett elébe s még két pengő forinttal is megajándékozta, sőt munkát is akart neki adni gyárában, hol perzsa szőnyegeket készitettek, mi Hollandiában szokásos volt.	Một người chưa hề làm phép rửa tội, tên là Jacques trông thấy cách dối đãi tàn ác như thế đối với một người đồng loại, một người đi hai chân, không có lông có cánh nhưng có một linh hồn; ông ta dắt chàng về nhà cho chàng tắm rửa và đưa bánh cùng rượu bia để chàng ăn uống.
Másnap sétaközben egy koldussal találkozott, ki mérges kelevényekkel volt boritva, szemei fénytelenek voltak, az orra vége lerohadt, szája lefittyedt, foga fekete, hangja rekedt volt, heves köhögés kinozta és minden rohamnál kiköpte egy fogát.	Ngày hôm sau trong khi chàng đi dạo, chàng gặp một người rách rưới tồi tệ, mắt đui, mũi sứt, miệng méo, răng đen, nói phều phào từ trong cuống họng, ho sù sụ và khi khạc đờm thì một cái răng rớt ra.
NEGYEDIK FEJEZET.	Chương IV
Hogyan találkozott Candide hajdani filozófia-tanitójával,	CHÀNG NGÂY THƠ GẶP LẠI THẦY CŨ, TRIẾT GIA PANGLOSS
Candide, inkább a részvéttől mint a borzalomtól indittatva, a jámbor Jacques anabaptistától kapott két pengő forintját odaadta a borzalmas állapotban lévő koldusnak.	Con người chỉ còn da bọc xương ấy chảy nước mắt nhìn chòng chọc vào chàng và muốn nhảy đến ôm chàng.
"Nagy ég!	- Chao ôi!
mondá a nyo­morult a másik nyomorultnak, hát nem ismered fel a te kedves Panglossodat?	Anh không nhận ra Pangloss của anh hay sao?
- Mit kell hallanom?	- Trời đất ơi!
te vagy az, drága mesterem, te jutottál ily borzalmas állapotba?	Mà ông lại ở trong tình trạng ghê tởm như thế này?
Mily szerencsét­lenség ért?	Ông đã gặp sự bất hạnh gì?
miért nem maradtál a világ legszebb kastélyában?	Tại sao ông không ở trong tòa lâu đài đẹp nhất?
Candide kinyitá szemeit.	Chàng mở mắt nói:
"Kunigunda meghalt!	- Cunégonde chết à?
Ó, hol talállak meg téged, elképzelhető legjobb világ?	Thế thì còn gì là hoàn thiện trên thế gian này nữa?
Erre Candide ismét elájult; de amint magához tért és mindent elmondott, ami a szivét nyomta, az okról és okozatról kezdett kérdezősködni s elegendő okát kereste annak, hogy Pangloss ily szánalmas állapotba jutott.	Sau khi nghe những lời ấy chàng Ngây Thơ ngất xỉu lần nữa; khi hồi tỉnh chàng nói chuyện huyên thuyên đủ điều, rồi hỏi nhà triết học Pangloss đâu là lý luận có nhân có quả, đâu là lí do đã làm cho nhà triết học đến nông nỗi này?
- Jaj!	- Than ôi!
Ami engem illet, én már senkire sem származtatom, mert én belehalok.	Đến tôi, tôi sẽ chẳng cho ai của ấy nữa, bởi vì tôi sẽ chết.
- Ó Pangloss!	- Ôi, Pangloss!
kiáltott fel Candide, milyen különös családfa!	chàng Ngây Thơ kêu lên, phả hệ đó mới lạ lùng làm sao!
Biztosan maga az ördög ennek az őse!	Chẳng phải quỷ dữ là nguồn gốc của nó đó sao?
- Egyáltalában nem, válaszolá a nagy férfiu, nélkülözhetetlen kelléke és szükséges alkotórésze ez a lehető legjobb világnak; mert ha Kolumbusz nem kapta volna meg Amerika egy szigetén ezt a nyavalyát, mely megmérgezi a nemzés forrását, sőt amely gyakran magát a nemzést is lehetetlenné teszi, mi világos ellen­tétben áll a természet nagy céljával, akkor nem lenne se csokoládénk se biborfestékünk; azonkivül figyelembe kell venni, hogy a mai napig csakis a mi földrészünkön terjedt el ez a betegség oly nagyon.	- Không hề, con người vĩ đại ấy đáp, đó là một cái gì đó tối cần thiết trong những cái trác tuyệt của mọi giới, một thành phần cần thiết; bởi vì nếu Colomb không tóm được, trên một hòn đảo ở châu Mỹ, cái căn bệnh đã đầu độc nòi giống ấy, cái căn bệnh luôn ngăn trở giống nòi, và cũng là cái đối lập với những mục đích của tự nhiên ấy, thì chúng ta làm gì có sôcôla, cũng chẳng có rệp son; cũng cần phải thấy rằng cho đến nay, trên hành tinh của chúng ta, căn bệnh ấy là của riêng chúng ta, cũng như việc lý sự vậy.
A törökök, indusok, perzsák, kinaiak, japánok még nem is ismerik, de megvan rá az elegendő ok, hogy néhány évszázad alatt ők is alaposan megismerjék.	Người Thổ Nhĩ Kỳ, người Ấn Độ, người Ba Tư, người Tàu, người Xiêm, người Nhật đều còn chưa biết đến nó; nhưng có một lý do đầy đủ để mà đến lượt họ biết được nó trong vài thế kỷ nữa.
- Mily csodálatos ez, mondá Candide, de téged meg kellene gyógyittatni.	- Nhưng bây giờ việc trước hết là phải làm cho tiên sinh hết bệnh.
Ezek a szavak elhatározásra birták Candide-ot; a kegyes anabaptista Jacques-nak lábai elé vetette magát és oly meghatóan festette le előtte barátja szánalmas állapotát, hogy a jámbor férfiu habozás nélkül házába fogadta Pangloss doktort és kigyógyittatta a saját költségén.	Những câu cuối cùng này làm cho chàng Ngây Thơ quyết định: Chàng sẽ tới nhà hảo tâm là ông Jacques; chàng sẽ quỳ gối trước mặt ông ta để mô tả một cách cảm động tình cảnh của nhà triết học, sau nhờ ông ta bỏ tiền ra chữa bệnh cho Pangloss.
Pangloss a kezelés alatt csupán egyik szemét és fülét vesztette el.	Nhà hảo tâm liền nhận Pangloss làm người giữ sổ sách.
A filozófus szépen tudott irni és kitünően értett a számtanhoz, igy hát az anabaptista Jacques könyvelőnek alkalmazta.	Sau hai tháng, ông phải đi Lisbonne vì công việc thương mại.
Két hónap mulva kénytelen lévén ügyeinek elintézése céljából Lisszabonba utazni, magával vitte hajóján a két filozófust.	Trên chiếc tàu buôn của ông, ông đem theo cả triết gia Pangloss và chàng Ngây Thơ.
Pangloss az uton megmagyarázta neki, hogy ezen a világon minden a lehető legjobban van elrendezve.	Pangloss giải thích cho ông tất cả mọi việc đều diễn tiến một cách hoàn thiện hơn như thế nào.
Jacques nem volt ezen a nézeten.	Jacques không đồng ý và đáp:
"Valahogy ugy kell legyen, mondá, hogy az emberek elhagyták eredeti természetöket, mert hiszen nem születtek farkasoknak és mégis farkasokká lettek.	- Con người đã làm hư hỏng cả thiên nhiên; họ không sinh ra là loài chó sói nhưng sau họ trở thành chó sói.
Isten se huszonnégy fontos ágyukat se szuronyokat nem adott az embereknek, és ők mégis szuronyokat és ágyukat gyártottak, hogy ezekkel pusztitsák egymást.	Thiên Chúa không cho họ súng thần công, không cho họ lưỡi lê, vũ khí, vậy mà họ làm ra lưỡi lê và súng thần công để tự tiêu diệt lẫn nhau.
Megemlithetném még a csődbejutottakat és az igazság-szolgál­ta­tást is, amely lefoglalván a bukott kereskedők vagyonát, megfosztja tőle a hitelezőket.	Tôi còn có thể nói thêm rằng trong những vụ khánh tận thì tòa án chiếm đoạt tài sản của những người bị khánh tận để mà gian lận tiền bạc của những chủ nợ.
- Mind­ez elkerülhetetlenül szükséges, válaszolá a félszemü doktor, és az egyesek szerencsétlensége az általános jólét forrása; igy aztán minél több bajuk van egyeseknek, annál nagyobb az általános jólét."	Nhà triết học chột mắt liền cãi lại: - Tất cả những sự kiện ấy đều là tối cần; những bất hạnh riêng biệt đã xây thành sự hữu hạnh của toàn thể; như vậy càng có nhiều sự bất hạnh riêng biệt bao nhiêu thì sự hữu hạnh công cộng càng hoàn thiện bấy nhiêu.
Mialatt filozófusunk igy elmélkedett, az ég elsötétült, a szélrózsa minden irányából hatalmas szél kerekedett és a hajót Lisszabon kikötője előtt rettenetes vihar támadta meg.	Trong khi Jacques đang lý sự thì gió lớn nổi lên tứ phía; con tàu gặp bão ghê gớm, khi gần tới hải cảng Lisbonne.
ÖTÖDIK FEJEZET.	Chương V
Vihar, hajótörés, földrengés; mi történt Pangloss doktorral,	BÃO TỐ, ĐẮM TÀU, ĐỘNG ĐẤT, KHIẾN CHO PANGLOSS, JACQUES VÀ CHÀNG NGÂY THƠ RA SAO
Az anabaptista segiteni óhajtott valamit s a fedélzeten tartózkodott; egyszerre csak egy őrjöngő matróz durván meglökte s ő elterült a padozaton.	Ai muốn làm gì thì làm, ai còn sức thì chống trả bão tố; không có ai chỉ huy, không ai nghe lời ai nữa.
De az erős ütéstől, melyet az anabaptistára mért, maga a matróz is annyira előre lendült, hogy fejjel lefelé kibukott a hajóból: megakadt és függve maradt egy törött árboc roncsán.	Jacques phụ tay vào việc lèo lái: ông bị một thủy thủ đang cơn tức giận đánh một đòn, làm cho ông ngã lăn trên đống ván.
A jámbor Jacques segitségére siet, kimenti őt, ámde a nagy iparkodás közben tengerbe pottyan a matróz szeme láttára.	Nhưng trong khi đánh ông thì anh chàng thủy thủ này bị tàu lắc mạnh đến văng ra ngoài, mắc kẹt vào một cột buồm gãy.
Ez veszni hagyja őt anélkül, hogy egy tekintetre is méltatná.	Jacques sẵn lòng từ thiện, chạy đến cứu anh lôi anh lên tàu.
Candide közeledik, észre veszi jóltevőjét, amint egy pillanatra kibukkan a vizből, majd örökre elmerül a hullámokban: utána akar ugrani a tengerbe, de a filozófus Pangloss megakadályozza őt, bebizonyitván, hogy a lisszaboni kikötő egyenesen azért alakult, hogy ott ez az anabaptista megfulladjon.	Vì sự cố gắng quá sức, ông té lăn xuống biển, trước cặp mắt lạnh lùng của tên thủy thủ không thèm ngó ngàng tới ông, để mặc cho ông bị làn sóng dìm xuống biển, chàng Ngây Thơ chạy tới gần ân nhân của chàng, trông thấy ông nổi lên một phút rồi chìm luôn mất dạng, chàng muốn nhảy xuống biển cứu ông nhưng triết gia Pangloss ngăn cản bằng cách biện luận rằng hải cảng Lisbonne đã được lập ra là để cho Jacques phải chết chìm ở đó.
Kissé magukhoz térve Lisszabon felé vették utjukat: volt még néhány garasuk s remélték, hogy ezzel megmenekülnek az éhségtől, miután a vihart már kiállották.	Khi đã hồi tỉnh, họ đi bộ tới thành phố Lisbonne; họ còn một ít tiền, hy vọng rằng khỏi phải chết đói, sau khi đã thoát chết vì bão tố.
A matróz fütyürészve és károm­kodva mondta: "Itt nyerhetünk valamit.	Nhà cửa sập đổ; những mái nhà chồng chất trên nền nhà.
- Vajjon mi lehet az elégséges oka ennek a tünemény­nek?	- Ở đây tất kiếm chác được đây.
- Ez a világ vége, kiáltott fel Candide."	- Đây là ngày tận thế rồi.
adj egy kis bort és olajat, mert különben meghalok.	- Chao ôi, cho tôi chút rượu và dâu, tôi chết mất.
Való­szinüleg egy kén-réteg húzódik el a föld alatt Limától Lisszabonig.	Những nguyên nhân giống nhau đều sinh ra những hậu quả giống nhau; chắc là một luồng diêm sinh chạy ở dưới đất từ Lima đến Lisbonne.
- Ez nagyon valószinü, mondá Candide, de az Istenre kérlek, adj egy kis olajat és bort.	- Có lẽ không gì đúng hơn nữa, chàng Ngây Thơ nói, nhưng vì Chúa, cho tôi chút dâu và rượu.
- Mit?	- Sao cơ, có lẽ là thế nào?
Candide elvesztette az eszméletét, mire Pangloss egy kis vizet hozott neki a közeli forrásból.	Chàng Ngây Thơ nằm bất tỉnh và Pangloss đem đến cho chàng một chút nước lấy ở cái giếng gần bên.
Egy kis fekete ember, az inkvizició megbizottja, ki épen mellette volt, udvariasan átvette a szót és ezt mondá: "Uraságod valószinüleg nem hisz az eredendő bűnben; mert ha minden a legjobban van, akkor nincs se bűnbeesés, se bűnhődés.	- Biến cố này còn khá lắm đó, vì nếu ở đây không có một núi lửa thì ở chỗ khác chắc có một núi lửa đang phun, còn tai hại biết mấy: tất cả mọi việc ở đây còn hơn ở những chỗ khác.
- A legalázatosabban bocsánatot kérek méltóságodtól, mondá Pangloss még udvariasabban; mert hát az ember bűnbeesése és kiátkozása szükségkép hozzátartoznak e lehető legjobb világhoz.	Một người mặc áo đen nhỏ bé, vốn là người quen thuộc với Pháp đình, đứng gần bên Pangloss lễ phép góp ý kiến: - Hình như ông không tin có tội tổ truyền; vì nếu cái gì cũng hoàn hảo hơn thì đâu có sự sa ngã, sự trừng phạt?
- Uraságod tehát nem hisz a szabad akaratban?	Pangloss trả lời một cách lẽ phép hơn:
kérdé az inkvizició bizalmas embere.	- Vậy ngài không tin ở tự do hay sao?
- Méltóságod meg fog nekem bocsá­tani, mondá Pangloss: szabad akarat létezhetik a feltétlen szabadság mellett is; mert elkerül­he­tetlenül szükséges volt, hogy szabadok legyünk, mert végül az akarat meg lévén határozva..."	- Xin ngài tha lỗi cho tôi; tự do có thể tồn tại với sự cần thiết tuyệt đối; chúng ta cần phải được tự do, vì ý chí quyết liệt…
Pangloss még be sem fejezte beszédét, midőn az inkvizició embere jelt adott szolgájának, ki a portoi és oportoi borokat töltögette.	Pangloss chưa dứt câu thì người kia đã hất hàm ra hiệu cho tên hầu cận đeo khí giới đang hầu rượu Porto hay Oporto cho ông ta.
HATODIK FEJEZET.	Chương VI
Ünnepélyesen máglyát raknak, hogy eretnek-égetéssel	Vụ động đất này đã thiêu rụi ba phần tư thành phố Lisbonne.
akadályozzák meg a földrengést; Candide-ot megbotozzák.	Đó là bí quyết hiệu nghiệm ngăn cản động đất.
A földrengés után, mely Lisszabon városát háromnegyed részben eltemette, az ország bölcsei nem tudtak hathatósabb módot kitalálni a teljes pusztulás elkerülésére, minthogy egy szép eretnek-égetést rendeznek a nép megnyugtatására.	Vì thế họ bắt một người ở Biscaye bị cáo là lấy người mẹ nuôi mình và hai người Bồ Đào Nha đã ăn thịt gà mà bỏ mỡ.
A Coimbre-i tudományegyetem megálla­pitotta, hogy néhány személynek fényes szertartások között, lassu tűzön való elégetése csalhatatlan titka annak, hogy a földrengést megakadályozzák.	Sau bữa cúng kiến người ta trói triết gia Pangloss cùng với đồ đệ của ông ta là chàng Ngây Thơ; một người phạm tội đã nói triết lí, còn một người đã nghe với vẻ tán thành.
Candide ijedten, a félelemtől csaknem eszét vesztve, vérbe boritottan, remegő szívvel mondá magában: "Ha ez az elgondolható legjobb világ, milyen lehet a többi?	Pangloss bị án thắt cổ dù rằng đó không phải là tập quán. Cùng ngày hôm ấy lại có động đất xảy ra với những tiếng đổ vỡ ghê sợ.
Az még csak hagyján, hogy engem megbotoztak, megtették ezt már a bulgárok is; de szegény drága Panglossom, a filozofusok legnagyobbika, mért kellett téged felakasztva látnom a nélkül, hogy tudnám az okát!	Chàng Ngây Thơ máu me đầy người, hoảng hốt, phập phồng lo sợ, lại bị giam cầm, lòng tự hỏi lòng: "Nếu mọi việc đều hoàn thiện hơn như ở đây thì ở những nơi khác ra sao?
Drága anabaptistám, emberek legjobbika, miért kellett látnom, hogyan fulladtál meg a kikötőben!	Khi ta gặp những người Bảo Gia Lợi, ta đã bị đánh đòn, việc ấy còn có thể bỏ qua được.
Ó, Kunigunda, leányok gyöngye, miért lettél te kéjgyilkos­ság áldozata."	Còn cô Cunégonde nữa, hòn ngọc trong giới thiếu nữ, sao cô lại bị người ta mổ bụng?"
Visszatántorodott: alig tudott a lábán megállni; agyonprédikálták, megbotozták, feloldották kötelékeit és megáldották, midőn egyszerre egy öreg asszony surrant hozzá s ezt sugta fülébe: "Fiam, légy bátor és kövess."	Chàng quay đi, đứng không vững, sau khi được nghe thuyết giáo, bị đánh đòn, được tha tội và ban phước, thì có một bà già đến hỏi chuyện chàng và bảo:
HETEDIK FEJEZET.	- Con ơi!
Hogyan gondoskodik Candide-ról egy öreg asszony;	Hãy can đảm và đi theo ta.
Csak dörzsöld magadat a kenőccsel, egyél és aludjál."	Ngày mai ta sẽ trở lại đây".
Candide szerencsétlensége dacára is evett és aludt.	Chàng Ngây Thơ dù đau đớn vẫn có thể ăn ngon ngủ kỹ.
Másnap az öreg asszony reggelit hozott neki, megtapogatta a vállát és sajátkezüleg bedörzsölte egy másfajta kenőcscsel: azután ebédet hoz neki s végül este is visszajön, hogy vacsorával lássa el.	Hôm sau bà già đem bữa điểm tâm cho chàng, thăm lại lưng chàng, tự tay bôi cho chàng một thứ thuốc khác; kế đến bà còn đem bữa ăn trưa và bữa ăn tối cho chàng nữa.
Harmadnapra megismételte ugyanezt az eljárást.	Những hôm sau nữa, bà lại làm đúng như vậy, không thiếu thứ gì.
"Ki vagy te, kérdé folyton Candide: ki oltott szivedbe ennyi jóságot?	Chàng Ngây Thơ hỏi bà: "Bà là ai mà có lòng tốt như vậy?
Hogyan hálálhatom meg mindezt?" A jóságos asszony sohasem felelt semmit: egy este ismét visszajött és ezuttal nem hozott vacsorát.	Tôi biết trả ơn sao đây?" Người phụ nữ tốt bụng không bao giờ trả lời.
"Jöjj velem, mondá és ne szólj egy szót sem." Karonfogja, átvezeti a mezőségen körülbelül negyed mértföldnyire, egy magányosan álló, kertektől és öntöző csatornáktól körülvett házhoz.	Một buổi tối bà lại đến, nhưng không đem theo bữa ăn mà chỉ bảo chàng: "Con hãy đi theo ta và đừng nói nửa lời".
Az öreg asszony kopogtat a kis kapun; kinyitják; elvezeti Candide-ot egy arannyal diszitett terembe, leülteti egy selyempamlagra, rázárja az ajtót és elmegy.	Bà dìu cánh tay chàng cùng đi với chàng một đoạn đường đến một vùng thôn quê lân cận.
Az öreg asszony csakhamar ujra megjelent, nagy fáradsággal támogatva egy remegő, fenséges termetü, drágakövekkel feldiszitett és lefátyolozott nőt.	Bà dẫn chàng Ngây Thơ lên một cái thang tới một căn phòng cẩn vàng, bảo chàng ngồi xuống một cái ghế dài lót nhung lụa.
"Huzd félre a fátyolt," mondá az öregasszony Candide-nak.	Rồi bà đi ra ngoài, khép cửa lại.
Mily meglepetés!	Thì ngạc nhiên thay!
Kunigundát vélte látni; valóban őt látta, mert ő volt az.	Chàng tưởng nằm mộng, thấy cô Cunégonde, chàng nhìn rõ thì chính là cô ta.
Ereje elhagyja és némán a lábai elé roskad, Kunigunda pedig a pamlagra hanyatlik.	Chàng không còn đủ sức đứng vững nữa, không còn nói được một lời nào, chỉ quỳ phục xuống.
Az öreg asszony azt tanácsolja nekik, hogy csendesebben legyenek és magukra hagyja őket.	Bà già bảo hai người đừng gây tiếng động, rồi bà để cho họ nói chuyện tự do.
"Hogyan?	- Sao?
Hát csakugyan te vagy itt!?	Cô chưa chết à?
- mondá Candide; te élsz és itt vagy Portugáliában?	Tôi gặp lại được cô ở Bồ Đào Nha sao!
Hát nem becstelenitettek meg s nem metszették fel a hasadat, mint a filozófus Pangloss állitotta?	Người ta không hiếp dâm cô, không mổ bụng cô như lời triết gia Pangloss đã nói với tôi sao?
- De igen, felelte a bájos Kunigunda; de e két baleset nem okvetlenül halálos.	- Có chuyện ấy, nhưng người ta không phải bao giờ cũng chết do hai tai biến này.
- És atyádat, anyádat igazán megölték?	- Còn thân phụ và thân mẫu cô có bị giết chứ?
- Meg bizony, mondá Kunigunda zokogva.	- Việc đó có thật, cô vừa đáp vừa khóc.
- És a bátyád?	- Còn anh cô thì sao?
- Őt is megölték.	- Anh tôi cũng bị giết chết.
- És hogyan kerülsz Portugáliába? Honnan tudtad, hogy én itt vagyok?	- Tại sao cô tới được nước Bồ Đào Nha?
Mily különös varázslattal juttattál ebbe a házba?	Sao cô biết tôi ở đây mà cho kêu tôi đến căn nhà này?
- Mindent el fogok mesélni, válaszolt a nő; de először neked kell elmesélned mindent, ami amaz ártatlan csók és az elszenvedett rugások óta történt veled."	- Tôi sẽ nói tất cả cho anh hay, nhưng trước hết anh phải cho tôi biết tất cả những gì đã xảy ra cho anh từ lúc anh tặng tôi cái hôn vô tội, rồi anh bị đá đít đuổi đi.
NYOLCADIK FEJEZET.	Chương VIII
Kunigunda története.	CÂU CHUYỆN VỀ CÔ CUNÉGONDE
Istenem!	- Ồ!
Remélem, hogy megláthatom - mondá naivul Candide.	Làm sao tôi coi được vết sẹo ấy.
Meg fogod látni, mondá Kunigunda; de hadd folytassam.	Chàng Ngây Thơ nói một cách khờ khạo.
- Folytasd, mondá Candide."	- Thì kể tiếp đi.
Kunigunda ujból felvette az elbeszélés fonalát:	Ông ta thấy tôi có nhan sắc; phải nhìn nhận điều ấy.
"Aztán egy fiatal ember lépett be; látta, hogyan fekszem ott vérbe boritva, de a katonát ez egy cseppet sem feszélyezte.	Tôi cũng thấy ông ta dễ thương và màu da trắng dịu; song ông ta không giỏi triết lí và không được thông minh cho lắm.
A kapitány haragra lobbant a gazfickó tiszteletlensége miatt és testemen ölte őt meg; aztán bekötöztette sebeimet és hadifogolyként vitetett szállására.	Sau ba tháng ăn xài đã hết tiền và đã chán tôi, ông ta bán tôi làm nô lệ cho một người Do Thái tên Issacar, từng buôn bán đầu cơ ở Hà Lan và ở Bồ Đào Nha, một người có tật yêu thiết tha đàn bà.
Három hónap mulva, miután eljátszotta mind a pénzét és rám is unt, eladott egy don Issacar nevü zsidónak, ki Hollandiában és Portugáliában kereskedett és aki szenvedélyesen szerette a nőket.	Tên Do Thái muốn chinh phục tôi mới dẫn tôi về tòa nhà vùng nông thôn, tức là tòa nhà hiện nay tôi ở. Từ trước đến giờ tôi vẫn tưởng lâu đài thân phụ tôi là đẹp nhất trần gian, nhưng tôi đã lầm!
A zsidó nagyon ragaszkodott hozzám, de nem tudott rajtam diadalmaskodni; neki jobban ellentálltam, mint a bulgár katonának; egyszer meg lehet becsteleniteni egy nőt, de erénye annál jobban megszilárdul.	"Một hôm vị quan tôn giáo Pháp đình gặp tôi đi lễ nhà thờ, ông cho người đến mời tôi về nhà nói chuyện bí mật.
A zsidó, hogy megpuhitson, ebbe a falusi villába hozatott.	Tôi được dẫn về tòa lâu đài của ông.
Eddig abban a hitben voltam, hogy nincs szebb a világon, mint Thunder-ten-tronckh báró kastélya; bevallom: csalódtam.	Trong khi nói chuyện, tôi cho ông biết tông chi của tôi thuộc về dòng dõi quyền quý.
Egyszer a nagy inkvizitor észrevett a misén; sokáig kacsintgatott rám s megizente, hogy titkos beszélni valója van velem.	Ông liền thuyết phục tôi, cho tôi hay rằng lấy một anh Do Thái là hạ thấp danh giá của tôi biết chừng nào!
Palotájába vittek; feltártam neki születésemet; ő meg azt bizonyitgatta, hogy nagyon is méltóságomon aluli, hogy egy zsidónak legyek a szeretője; ajánlatot tett don Issacarnak, hogy engedjen át neki.	Ông cho người đi đến gặp Issacar, người Do Thái đã mua tôi làm nô lệ, để khuyên anh này nhường tôi lại cho ông.
Don Issacar, ki udvari bankár s mint ilyen, nagy tekintélyü ember, hallani sem akart a dologról.	Anh Issacar là chủ ngân hàng của triều đình, có thế lực, nên không chịu.
Az inkvizitor máglyával fenyegetődzött.	Ông quan bèn dọa sẽ làm tội hỏa thiêu anh ta.
Hat hónapja van érvényben ez az egyezség.	Nhưng không phải được trơn tru êm ấm.
Igaz, hogy voltak civakodások is; mert gyakran nem tudták eldönteni, vajjon a szombatról vasárnapra virradó éjjel a régi vagy uj birtokost illeti-e. Ami engem illet, mindkettőnek ellenálltam s azt hiszem, ennek tulajdonit­hatom, hogy változatlanul szeretnek.	Cũng có những chuyện xung đột xảy ra vì một chi tiết đã không được dự trù trước; bởi vì không biết được là đêm thứ Bảy đến ngày Chủ nhật thuộc về luật cũ hay luật mới nên cũng chẳng biết nó thuộc về của ai.
Végül, hogy a földrengést elháritsa és Don Issacart meg­félemlitse, elhatározta az inkvizitor ur, hogy eretnek égetést rendez.	Về phần tôi, tôi kháng cự cả hai người cho đến bây giờ và có lẽ vì thế mà tôi được cả hai người yêu tôi tha thiết.
Megdörzsöltem szemeimet, majd figyelmesen néztem őt és láttam, amint felakasztották; ekkor ájultan estem össze.	Nhưng tôi bỗng ngạc nhiên, bối rối, kinh hãi biết bao khi thấy một người giống như Pangloss tiên sinh, mặt bị che lấp bởi cái mũ ma quỷ.
Alig tértem magamhoz, midőn téged láttalak meg teljesen meztele­nül; ekkor már a borzalomnak, meglepetésnek, a fájdalomnak, kétségbeesésnek tetőpontjára jutottam.	Tôi dụi mắt nhìn kỹ thì thấy người ấy bị thắt cổ; tôi rùng rợn té xỉu; khi tỉnh lại, thì tôi lại thấy anh bị lột trần, thật vô cùng kinh khủng, hãi hùng, đau đớn, tuyệt vọng.
Miközben téged alaposan megbotoztak, azt kérdezgettem magamtól: hogyan lehetséges az, hogy a szeretetreméltó Candide és a bölcs Pangloss Lisszabonba kerülnek, az egyik, hogy száz kor­bácsütést kapjon, a másik, hogy a főinkvizitor méltóságának, az én szeretőmnek parancsára felakasztassék.	Tôi tự hỏi: "Tại sao chàng Ngây Thơ yêu dấu và tiên sinh Pangloss lại bị lưu đày đến Lisbonne để mà ngày nay chịu thảm họa như thế này, người thì bị đánh trăm roi, người thì bị treo cổ theo lệnh ngài pháp quan, là người yêu quý mình?
Pangloss tehát kegyetlenül megcsalt engem, midőn azt állitotta, hogy minden legjobb a világon.	Hay là Pangloss tiên sinh đã lừa tôi một cách tàn ác, khi ông bảo tôi rằng: "Cứ yên tâm, mọi việc rồi sẽ tốt hơn."
Hálát adtam Istennek, ki annyi megpróbáltatás után visszavezérelt téged.	Tôi xúc động nhất là lúc thầy Pangloss bị hình tội và anh thì bị xử đánh.
Megparancsoltam az öreg asszonynak, hogy viselje gondodat és vezes­sen ide, ameddig ez lehetséges.	Tôi mơ tưởng lại cái hôn anh đã tặng tôi lần đầu, sau bức bình phong, trong cái ngày gặp anh lần chót.
Itt lelte őket don Issacar, a nyári lak egyik tulajdonosa.	Nhưng bây giờ chắc anh đói lắm rồi, tôi cũng đang rất đói.
Szombat volt; eljött, hogy jogait élvezze és gyöngéd szerelmét tolmácsolja.	Chúng ta hãy bắt đầu ăn uống đã".
KILENCEDIK FEJEZET.	Thế là hai người ngồi vào bàn ăn.
Mi történt Kunigundával, Candide-dal, a nagy inkvizitorral és a zsidóval?	Sau bữa ăn, họ lại ra ghế trường kỷ ngồi nói chuyện.
Ez az Issacar egyike volt a legharagosabb hébereknek, akik csak éltek eddig Izraelben a babyloni fogság óta.	Đang nói chuyện thì họ thấy người Do Thái Issacar, một trong hai vị chủ nhà, bước vào.
"Mit?	Chương IX
Ámde a mi derék westphaliai barátunk a ruházattal együtt egy szép kardot is kapott az öreg asszonytól.	Y la lớn: "Đồ chó cái Galilée, mi đã chia sẻ mối tình với tên quan tòa của tôn giáo Pháp đình còn chưa đủ sao?
Kardot rántott, ámbár egyébként a legszelidebb természetü volt s a következő pillanatban az izraelita holtan terült el a szép Kunigunda lábainál.	Chàng liền rút kiếm, dầu tính tình chàng hiền lành bấy lâu nay; chàng đâm tên Do Thái chết nằm sóng sượt trên sàn nhà, dưới chân cô Cunégonde.
"Szent szüz anyánk!	Cô la lên: "Đức Mẹ ơi!
- kiáltott a leány; mi lesz velünk?	Chúng ta sẽ ra sao đây?
Egy embert öltél meg nálam!	Một người bị giết tại nhà tôi!
Ha a rendőrség belép, el vagyunk veszve.	Nếu công lý can thiệp thì chúng ta nguy mất!"
- Ha Panglosst nem akasztották volna fel, szólt Candide, biztosan jó tanácsot adna ebben a nehéz helyzetben, mert ő nagy filozófus volt.	Chàng Ngây Thơ đáp: - Nếu triết gia Pangloss không bị treo cổ thì ông đã giúp cho chúng ta một lời chỉ bảo trong trường hợp cực đoan này, vì ông là một nhà đại hiền triết.
Éjfél után egy óra volt, a vasárnap kezdete: ez a nap már az inkvizítor urat illette.	Lúc ấy là một giờ đêm, kể như bắt đầu ngày chủ nhật, là ngày của ngài pháp quan.
Belép és ott látja a megbotozott Candide-ot karddal kezében, egy halottal a földön elterülve, Kunigundát halálra rémülve és az öreg asszonyt, amint tanácsokat osztogat.	Ngài bước vào trong phòng; trông thấy chàng Ngây Thơ tay cầm đoản kiếm; dưới đất một tử thi nằm dài; cô Cunégonde sợ hãi, còn bà già thì đang lý luận, cho ý kiến.
Ebben a pillanatban ily gondolatok cikáztak át Candide agyában: "Ha ez a szent ember most segitségért kiált, kétségtelenül máglyára fog hurcoltatni.	Lúc này chàng Ngây Thơ suy luận: "Nếu ông lớn này mà kêu lên thì chắc chắn ông ta có thể làm cho ta bị xử hỏa thiêu; cô Cunégonde cũng sẽ có thể chịu chung số phận như ta.
Kunigundának is ez lenne a sorsa.	Ông ta đã từng cho đánh ta tàn nhẫn.
Szivtelenül megkorbácsoltatott; ezenfelül vetélytársam is; megölöm őt habozás nélkül." Ez az okoskodás világos és gyors volt; és időt sem engedve az inkvizítornak arra, hogy magához térjen meglepetéséből, keresztül szurja és odalöki a zsidó mellé.	Ta lại là kẻ tình địch của ông, không cần do dự gì nữa." Suy luận vắn tắt và mau lẹ, chàng không để cho ông quan tòa qua khỏi cơn ngạc nhiên; chàng đâm cho ông một nhát kiếm từ bên này qua bên kia bụng, và đẩy tử thi nằm bên cạnh tên Do Thái.
"Ime itt a másik is, mondá Kunigunda.	Cunégonde liền nói: "Lại thêm một cái chết nữa.
Nem lehet már szó megkegyelmezésről; meg vagyunk átkozva, elérkezett utolsó óránk.	Chúng ta phải đi xa nơi này; giờ chót của chúng ta đã tới.
Hogyan voltál rá képes te, ki oly gyöngédnek születtél, hogy két perc alatt megölj egy zsidót és egy főpapot?	Em không hiểu tại sao anh bẩm sinh là người nhu mì mà nay lại có thể trong hai phút giết một người Do Thái và một ông tòa?"
- Kedvesem, felelé Candide, ha az ember szerelmes, féltékeny és megvesszőztetésen ment át, akkor nem ismer többé magára."	Chàng Ngây Thơ trả lời: "Khi người ta si tình và ghen tuông, sau khi bị pháp luật đánh đòn đau đớn, thì người ta không còn biết gì nữa!"
Ekkor az öreg asszony szólalt meg: "Három andaluziai ló van az istállóban, felnyergelve és kantározva.	Bà già cất tiếng bảo cả hai người: "Hiện nay có ba con ngựa giống tốt trong chuồng ngựa, sẵn sàng yên cương.
Candide tüstént felkantározta a három lovat és Kunigunda, az öreg asszony meg ő harminc mérföldet tesznek meg egy huzamban.	Chàng Ngây Thơ đưa ba con ngựa ra; chàng cùng bà già và cô Cunégonde cưỡi ngựa đi một mạch ba mươi dặm.
Mialatt ők szöknek, a szent Hermandad megérkezik a nyári lakba: őméltóságát egy szép templomban temetik el és Issacart a szemétdombra vetik.	Trong khi họ đang cao chạy xa bay thì hội thánh Sainte-Hermandad đến ngôi nhà, người ta mai táng đức ngài trong một nhà thờ đẹp, còn thì người ta ném tên Issacar ra bãi rác.
Candide, Kunigunda és az öreg asszony már a kis Avacena városkában voltak, a Sierra-Morena hegységei között és igy beszélgettek egy korcsmában:	Cả ba người đã tới tỉnh nhỏ Avacéna, ở giữa vùng núi Sierra Morena và vào cư ngụ ở một quán trọ.
TIZEDIK FEJEZET.	Chương X
Mily nyomoruságos helyzetbe jutnak Candide, Kunigunda	BA NGƯỜI XUỐNG TÀU VƯỢT BIỂN
és az öreg asszony Cadixban; hogyan szállnak hajóra.	Tại quán trọ, cô Cunégonde vừa nói vừa khóc:
"Vajjon ki lophatta el aranyaimat és gyémántjaimat?	- Ai đã ăn cắp ngọc vàng và kim cương của tôi nè?
Hol találok még egy inkvizítort és még egy zsidót, ki ismét pénzhez juttat?	Đâu còn kiếm ra được người giàu có như anh Do Thái và ông quan tòa ấy, để tặng lại cho tôi những bảo vật khác nữa?
- Istenem!	- Than ôi!
sóhajtott az öreg asszony, erősen gyanakodom egy tisztelendő atyára, ki tegnap Badajozban velünk egy korcsmában lakott.	Bà già nói, tôi rất nghi ngờ ông linh mục dòng François, đêm qua cùng ngủ trọ với chúng ta trong cùng một quán ở Badajoz.
Isten őrizzen meg attól, hogy elhamarkodott itéletet mondjak, de amaz kétszer is bejött szobánkba és sokáig együtt jött velünk.	Tôi không dám ức đoán một cách táo bạo, nhưng tôi thấy ông ta vào phòng chúng ta hai lần và ông ta rời quán trọ trước chúng ta khá lâu.
- Istenem, sóhajtott Candide, a jó Pangloss gyakran bizonyitgatta, hogy a föld javai közös tulajdonaink, hogy mindenkinek egyenlően van joga hozzájok.	- Tôi còn nhớ, chàng Ngây Thơ nói, triết gia Pangloss thường chứng minh rằng tất cả của cải trên cõi đời đều là của chung cho mọi người, ai cũng có quyền hưởng ngang nhau.
De ezen elvek értelmében a barátnak meg kellett volna annyit hagynia, hogy legyen miből folytatnunk az utazásunkat.	Theo nguyên tắc ấy, thì ông linh mục phải để lại cho chúng ta một phần của cải, để chúng ta hoàn tất cuộc hành trình của chúng ta.
Tehát semmid sem maradt, kedves Kunigundám?	Nhưng nay chẳng còn gì hết cả, phải chăng cô Cunégonde xinh đẹp của tôi?
- Egy árva fillérem se, mondá a leány.	- Không còn một xu nhỏ. Cô đáp.
- Mihez fogjunk hát?	- Vậy thì phải làm sao đây?
kérdé Candide.	chàng hỏi.
- Adjuk el az egyik lovat, mondá az öreg asszony; én a kisasszony mögött fogok guggolni, ámbár csak az egyik ülepemen tudok ülni s igy majd eljutunk Cadixba."	- Chúng ta hãy bán một trong ba con ngựa của chúng ta, bà già bàn vậy.
Ugyane szálláson volt egy benedekrendi rendfőnök, ez jó olcsón megvette a lovat.	Tôi sẽ ngồi trên con ngựa của cô nương, sau lưng cô và chúng ta sẽ tới Cadix.
Candide, Kunigunda s az öreg asszony átmentek Lucenan, Chillason, Lebrixán s végre Cadixba érkeztek.	Tại quán trọ, lúc ấy có một tu viện trưởng dòng Thánh Benoit nhận mua con ngựa với giá rẻ.
Tehát kapitány lett; hajóra száll Kunigundával, az öreg asszonnyal, két szolgával s a két andaluziai lóval, mely azelőtt Portugália nagy inkvizitorának a tulajdona volt.	Chàng xuống tàu với cô Cunégonde, bà già, cùng hai người hầu cận và hai con ngựa giống tốt mà chàng đã lấy của ngài pháp quan Bồ Đào Nha.
A hajózás alatt sokat gondolkoztak a szegény Pangloss filozófiáján.	Trong khi vượt biển, ba người bàn luận về triết lý của Pangloss.
"Más világ felé evezünk, mondá Candide.	Chàng Ngây Thơ nói:
Ebben az uj világban biztosan minden jól van; mert azt meg kell adni, hogy a mi világunknak ugy fizikai, mint erkölcsi állapota sok panaszra ad okot.	- Chúng ta sắp đến một thế giới khác; có lẽ tại đó tất cả mọi việc đều hoàn hảo.
- Szivemből szeret­lek, mondá Kunigunda; de a lelkem még teljesen meg van rendülve mindattól, amit láttam és tapasztaltam.	Vì chúng ta phải nhận rằng trong thế giới của chúng ta, người ta phải than phiền một chút về phương diện vật chất và tinh thần.
- Adja Isten, hogy ugy legyen!	- Mọi việc sẽ tốt hơn, chàng Ngây Thơ cãi lại.
- Még te is panaszkodol, mondá az öreg asszony; oh Istenem, hátha még olyan szerencsétlenségeken mentél volna át, mint én."	- Cầu Chúa cho được như vậy, nhưng em đã quá khổ sở nên lòng em đóng kín, không còn để cho hy vọng nào lọt vào. Bà già xen vào nói:
- Kisasszonykám, válaszolt az öreg asszony, te nem is sejted az én származásomat; és ha megmutatnám neked az ülepemet, nem beszélnél igy és nem hamarkodnád el a sorsomról való itéletet."	- Thưa cô nương, bà già đáp, cô nương không biết dòng dõi của tôi; nếu tôi nói rõ ra thì chắc là cô nương phải ngưng hết lời phán đoán của cô nương.
TIZENEGYEDIK FEJEZET.	CU CHUYỆM CỦA BÀ GIÀ
Az öreg asszony története.	Bà già thuật lại cuộc đời của bà:
Tizennégy éves koromig olyan palotában neveltek, hogy mellette a te német báróidnak kastélyai még istállószámba sem mehettek volna és egyetlen egy ruhámnak több értéke volt, mint Westphalia összes kincseinek.	Tôi được nuôi dưỡng cho tới mười bốn tuổi trong một cung điện mà nếu so sánh thì các lâu đài của hàng nam tước nước Đức của các ông chỉ đáng là chuồng ngựa.
Igy növekedtem szépségben, bájosság­ban, tehetségem kifejtésében, öröm, tisztelet és remény között; akkor már szerelmet keltettem; keblem is kifejlődött s milyen kebel!	Lớn lên, tôi càng đẹp, càng duyên dáng, càng tài ba; ở giữa những cuộc vui chơi, tôi được hưởng những sự tôn kính và có tương lai sán lạn.
fehér és telt, mint a medici Vénuszé!	Lông mày mới đen làm sao!
és a szemeim milyenek voltak s a szempilláim és fekete szemöldökeim!	Ánh long lanh loé lên trong mắt tôi át hẳn tia sáng long lanh của các vì sao, như những thi sĩ chỗ tôi từng ca ngợi.
milyen lángok lobogtak szemeim­ben, hogy elhomályositották a csillagok ragyogását is - igy mondták vidékünk költői.	Những thị tì thay quần áo cho tôi đều phải ngây ngất khi nhìn phía trước hoặc phía sau của tôi.
Az asszonyok, kik öltöztettek és vetkőztettek, extázisban voltak, ha - akár elől, akár hátul - megtekintettek és minden ember szeretett volna az ő helyökben lenni.	Tất cả những người đàn ông có lẽ đều muốn biến thành những thị tì ấy.
Menyasszonya lettem Massa-Carrara uralkodó hercegének.	"Về sau, tôi đính hôn với một ông hoàng tối cao xứ Massa-Carrara cũng đẹp như tôi, tính tình dịu hiền và khả ái, thông minh lại diễm tình.
Már csaknem boldogságom pillanatához jutottam, midőn egy vén márkinő, ki hercegemnek szeretője volt, meghivta őt egy csésze csokoládéra: két óra alatt iszonyatos görcsök közt szenvedett ki a herceg: de ez még semmi.	Đang khi tôi lên đến đỉnh điểm của hạnh phúc thì một bà hầu tước già, trước kia là tình nhân của ông hoàng ấy, mời ông đến nhà dùng sôcôla.
Gyönyörü birtoka volt Gaëta vidékén; egy hazai hajóra szálltunk fel, melyet oly dusan diszitett az arany, akár a római Szent Péter templom oltárát.	Thân mẫu của tôi thất vọng và dầu không đau khổ bằng tôi, bà cũng muốn đi xa ít lâu để tránh nơi buồn thảm.
Egy szalei kalóz üldözni kezd és utolér bennünket; katonáink ugy védekeztek, mint az a pápa katonáihoz illik; fegyvereiket eldobálva valamennyien térdre vetették magukat és könyörögtek a kalóznak, hadd vehessék fel a halotti szentségeket utolsó órájokban.	Bà có một thửa đất rất đẹp ở gần tỉnh Gaètes; mẹ con tôi dùng một chiến thuyền ra đi, một chiến thuyền mạ vàng như bàn thờ thánh Pierre ở La Mã.
Egy-kettőre meztelenre vetkőztették őket, mint a majmokat, anyámat és az udvarnőket is, engem hasonlóképen.	Bỗng nhiên một tàu cướp biển ở Salé xông tới và tràn ngập chiến thuyền của chúng tôi.
Megtudtam, hogy a hithű maltai lovagok sem mulasztják ezt el, valahányszor törököket vagy török nőket ejtenek fogságba: oly köve­telménye ez a nemzetközi jognak, melyet sohasem sértettek meg.	Sau đó tôi mới hiếu rằng chúng muốn tìm xem chúng tôi có giấu hột xoàn không; đó là một tục lệ đã được đặt ra từ thời sơ cổ trong những nước bán khai mà dân chúng phiêu lưu ngoài biển.
Mondhatom, hogy Palestrina hercegnőjének és nekem nagyon erőseknek kellett lennünk, hogy kibirjuk mindazt, ami Marokkóba való érke­zésünkig reánk várt!	Nhưng tôi không thể giữ được bao lâu: Bông hoa tươi thắm để dành cho ông hoàng xứ Massa-Carrara, nay bị tên tướng cướp biển chiếm đoạt.
de hagyjuk ezeket; olyan mindennapi dolgok ezek, hogy nem is érdemes róluk beszélni.	Chúng ta hãy bỏ qua những việc không đáng nhắc lại ấy.
Alighogy partra szálltunk, midőn egy, az én kalózommal ellenséges fekete csapat el akarta ragadni zsákmányát.	Chúng cướp kim cương, vàng bạc, rồi sau đến con người chúng tôi, mà chúng coi cũng là quý vật đáng giá.
Az oroszlánok, tigrisek és kigyók dühével harcoltak: igy akarták eldönteni, kiknek jussunk a birtokába.	Họ đánh nhau cuồng nhiệt như những con sư tử, những con cọp, những con rắn địa phương; kẻ nào thắng thì được chiếm đoạt chúng tôi.
Egy mór ragadta meg anyámat a jobb karjánál fogva, egyik hadnagyunk viszont a balkarjánál fogva tartotta; egy mór katona egyik, egy kalóz a másik lábát ragadta meg: csaknem valamennyi udvar­hölgyünknek ez lett a sorsa, négy-négy katona huzta őket négy felé.	Một thổ dân nắm cánh tay mặt của mẫu thân tôi, trong khi viên phó thuyền trưởng của chiếc tàu chở tôi, giữ cánh tay trái; một binh sĩ địa phương giằng lấy một chân của bà, trong khi một tên giặc nắm lấy chân còn lại.
Nagy nehezen elvonszoltam magam a vérző tetemek tömegéből és egy közeli patak mellett álló narancsfa alá menekültem; ott a rémülettől, kimerültségtől, borza­lomtól, kétségbeeséstől s éhségtől összeestem.	Những cảnh tượng rùng rợn như vậy cũng xảy ra trong suốt ba trăm dặm; vậy mà người ta không quên năm buổi lẽ cầu nguyện mỗi ngày, mà đức giáo chủ Mohamet đã truyền cho dân Hồi phải tuân theo.
Lassanként kábitó álomba merültem, mely inkább ájulást hozott, mint pihenést.	Liền đó tôi ngất đi trong một giấc ngủ dài giữa cái sống và cái chết.
TIZENKETTEDIK FEJEZET.	Chương XII
Az öreg asszony tovább meséli viszontagságait.	CÂU CHUYỆN TIẾP VỀ NHỮNG ĐAU KHỔ CỦA BÀ GIÀ
"Elcsodálkoztam s egyben el is voltam ragadtatva anyanyelvem hallatára s nem kevésbé lévén meglepődve ezen ember szavai fölött, azt feleltem neki, hogy sokkal nagyobb szerencsétlen­ségek is vannak a világon, mint ami miatt ő panaszkodik; néhány szóval elmeséltem neki a kiállott borzalmakat és ismét elájultam.	"Tôi ngạc nhiên và sung sướng được nghe nói tiếng Ý, tiếng mẹ đẻ của tôi, và tôi cũng không kém ngạc nhiên về những lời thốt ra ở miệng người ấy; tôi đáp lại ông ta rằng còn có nhiều nỗi bất hạnh còn lớn hơn nhiều so với nỗi bất hạnh mà ông vừa than phiền.
"Nápolyban születtem, mesélte; ott évente két-háromezer gyermeket szoktak férfiasságuktól megfosztani: egyesek bele is halnak; némelyek még az asszonyoknál is szebb hangot nyernek; mások viszont az állam kormányzói lesznek.	Ông đưa tôi vào một nhà kế cận, cho tôi ăn uống, an ủi tôi, ca tụng tôi rằng ông chưa bao giờ thấy người đẹp bằng tôi.
- Az én anyámnál!	- Tôi sinh tại thành phố Naples.
kiáltottam.	Tôi la lên:
- A te anyádnál!	- Chính tôi đây!
- Soha, felelt a bárónő.	- Chưa bao giờ hết!
Midőn az iszonyu pestis első dühöngése véget ért, eladták a dey rabszolgáit.	Y bán lại tôi cho một lái buôn khác; tên này lại bán tôi cho một người ở Tripoli.
Volt köztünk egy jámbor és résztvevő imám, ki megható beszédet mondott nekik s azt ajánlotta, hogy ne öljenek meg egyszerre.	Ông ta chữa khỏi cho chúng tôi, và suốt đời tôi vẫn nhớ rằng, khi vết thương của tôi lành hẳn, ông ta gạ gẫm tôi.
Nyo­mor­ban és megalázásban öregedtem meg és bár csak fél ülepem volt, gyakran visszaemlékez­tem arra, hogy egy pápa leánya vagyok: százszor is öngyilkos akartam lenni és mégis ragaszkodtam az élethez.	Và còn gì ngu xuẩn bằng đã ghê tởm bản thân mình mà lại cứ khư khư giữ lấy nó; tay vẫn cứ vuốt ve con rắn độc xâu xé mình cho đến lúc nó ăn đến trái tim mình?
Ez a nevetséges gyengeség talán egyike a leggyászosabb, velünk született hajlamoknak; mert van-e ostobább dolog, minthogy folytonosan viseljünk egy terhet, melyet szeretnénk földhöz vágni; melengetjük a kigyót, mely mardos bennünket, mig végre a szivünkbe eregeti mérgét.	"Tại các xứ mà số phận đã bắt tôi đi qua, trong các tửu quán mà tôi làm kẻ hầu hạ, tôi từng thấy vô số kẻ chán đời cay đắng, vậy mà chỉ có được 12 người dám kết liễu đau khổ của họ: ba người mọi da đen, bốn người Anh, bốn người Genève, và một giáo sư Đức tên là Robeck.
Legutóbb Don Issacarnak lettem szolgája: te melléd rendelt, bájos kis urnőm; azóta annyira hozzá nőttem a sorsodhoz, hogy sokkal jobban elfoglaltak a te viszontagságaid, mint a magaméi.	Song cô đã gửi lại ký ức của tôi và có thông lệ trong khi con tàu đi xa là hành khách thường kể cho nhau nghe những câu chuyện của mình, cho đỡ buồn.
Soha nem emlitettem volna szerencsétlenségemet, ha nem unszoltál volna rá és ha nem volna szokás, hogy a hajón unalomüzésből meséljen az ember.	Tôi là người đã từng trải việc đời, tôi hiểu thế thái nhân tình.
TIZENHARMADIK FEJEZET.	Chương XIII
A szép Kunigunda, miután meghallgatta az öreg asszony történetét, oly tisztelettel viseltetett vele szemben, amilyen egy magasrangu és érdemekben gazdag személyt megillet.	Cô Cunégonde nghe xong câu chuyện của bà già, bèn thi lễ với bà đúng theo nghi thức đối với cấp bậc quý tộc của bà và giá trị của bà.
Ajánlatát elfogadta; az utasokkal, egyikkel a másik után elmeséltette élettörténetöket.	Cô cũng chấp nhận đề nghị của bà: cô yêu cầu hành khách lần lượt thuật lại cuộc đời của mình cho tất cả mọi người cùng nghe.
Candide is, ő is belátta, hogy az öreg asszonynak igaza volt.	Chàng Ngây Thơ và cô phải chịu là bà già có lý.
Miközben valamennyien elmesélték élettörténetöket, a hajó előre haladt és Buenos-Ayreshez ért.	Tôi sẽ cảm thấy đủ sức khỏe để lễ phép đưa ra vài điều bác luận đối với ý kiến của ông".
Kunigunda, Candide kapitány és az öreg asszony egyenesen a kormányzóhoz: Don Fernando d’ Ibaraa, y Figueora, y Mascarenes, y Lampourdos, y Souzához mentek.	Tàu cập bến. Cô Cunégonde, đại uý Ngây Thơ và bà già đến viếng thăm Tổng trấn Don Fernando d’Ibaraa y Figueora y Mascarenes y Lampourdos y Souza.
A nőket őrülten szerette s Kunigundánál - ugy tünt - még sohasem látott szebb teremtést.	Điều ông hỏi cô trước hết là cô có phải là vợ đại uý Ngây Thơ không?
Az volt első kérdése, hogy nem felesége-e Kunigunda a kapitánynak.	Chàng không dám nói cô là vợ chàng và sự thật cô chưa phải là vợ.
Olyan képpel kérdezte ezt, hogy Candide-nak arcába szökött a vér: nem merte azt mondani, hogy a felesége, mert hiszen nem is volt az; azt se merte mondani, hogy a nővére, mert nem volt az; és ámbár e hivatalos hazugság a régi világban is, az ujban is kapóra jön, az ő lelke sokkal ártatlanabb volt, mintsem hogy füllenteni tudott volna.	Chàng cũng không dám nói cô là em và điều này cũng không đúng nữa; lối nói dối như vậy rất hợp thời với người xưa và cũng còn có ích cho người đời nay nữa; song chàng Ngây Thơ có một tâm hồn trong trắng quá, khiến chàng không thể nói sai sự thật.
Don Fernando d’ Ibaraa, y Figueora, y Mascarenes, y Lampourdos, y Souza bajuszát végig­simitva kajánul mosolygott s megparancsolta Candide kapitánynak, hogy azonnal menjen csapatszemlét tartani.	Don Fernando dlbaraa y Figueora y Mascarenes y Lampourdos y Souza vểnh râu mép lên, mỉm cười cay đắng rồi lệnh cho đại uý Ngây Thơ đi duyệt binh trong liên đội của chàng, chàng tuân lệnh.
Candide engedelmeskedett: a kormányzó egyedül maradt Kunigunda kisasszonnyal.	Vị tổng trấn ở lại với cô Cunégonde.
Bevallotta neki szenvedélyes szerelmét és ünnepélyesen igérte, hogy másnap örök hűséget esküszik neki a templomban vagy a templomon kivül, amint a leány jobban óhajtja.	Ông tỏ tình với cô, thề rằng ông yêu cô, ngay ngày mai sẽ làm lễ cưới với cô nếu cô chịu và hôn lễ sẽ cử hành ở nhà thờ hay theo bất cứ tục lệ nào khác mà cô muốn, sao cho xứng với sự quyến rũ của cô.
Az öreg asszony nagyon jól sejtette, hogy egy csuhás barát lopta el Kunigunda pénzét és ékszereit.	Bà già trước kia đã đoán đúng là vị mục sư dòng François đã lấy cắp tiền bạc và châu báu của cô Cunégonde khi cô hấp tấp trốn tránh với chàng Ngây Thơ.
Badajoz városában, midőn a lány Candide-dal lóhalálában menekült.	Vị mục sư ấy sau đem bán vài món báo vật cho một nhà kim hoàn.
A barát néhány ékszert el akart adni egy ékszerésznek; az ékszerész felismerte bennök a nagy inkvizi­tor tulajdonait.	Nhà buôn bán này nhận ra được mấy món nữ trang mà vị Đại pháp quan đã mua để tặng cô Cunégonde người yêu… Thế là vụ lấy cắp đổ bể.
Kunigunda és Candide szökése közismert volt: Cadixig üldözték őket és haladék nélkül hajót küldtek további üldözésükre.	Rồi không bỏ mất thì giờ, người ta cho một cái tàu đuổi theo bọn cô, đến tận hải cảng Buénos-Ayres.
A hajó már Buenos-Ayres kikötőjébe érkezett: elterjedt a hire, hogy egy spanyol biró szándékozik kiszállni és hogy a nagy inkvizitor őméltóságának gyilkosait üldözik.	Tức thì có tin đồn vị pháp quan trên tàu có nhiệm vụ truy nã những kẻ sát nhân đã giết chết "Ngài Đại pháp quan của Tôn giáo Pháp đình".
TIZENNEGYEDIK FEJEZET.	Còn chàng Ngây Thơ?
Hogyan fogadták Candide-ot és Cacambot Paraguayban a jezsuiták?	Không còn một phút đồng hồ bỏ phí được nữa.
Mindenféle foglalkozása volt már: minisztráns fiu, sekrestyés, matróz, barát, levélhordó, katona, lakáj; Cacambónak hivták, gazdáját nagyon szerette, mert ez felette jó volt hozzá.	Người ta còn thấy hạng người này khá nhiều ở miền duyên hải Y Pha Nho và các thuộc địa. Y là người Y Pha Nho một phần tư sinh tại tỉnh Tucuman con một người lai.
Egy-kettőre megnyergelte a két andaluziai paripát: "No most, gazdám, fogadjuk meg a vén asszony tanácsát; oldjunk kereket és ne is nézzünk hátra." Candide nem tudta visszatartani könnyeit: "Ó drága Kunigundám, éppen akkor kell téged itt hagynom, midőn a kormányzó ur össze akar adni bennünket.	Lúc nhỏ y là một lễ sinh trong dàn nhạc nhà thờ, sau làm người giúp lễ, rồi làm đủ nghề: thuỷ thủ, thầy tu, nhân viên phát thư bưu điện, đi lính, và làm bồi ngựa.
Ó Kunigunda, ki oly messziről kerültél ide, mily sorsra fogsz jutni?	Y tên là Cacambo, rất mến chủ vì chủ y rất tốt với y.
- Azt fogja tenni, amit tehet, mondá Cacambo; az asszonynép sohasem jön zavarba, gondol rá a jó Isten; de most már meneküljünk!	Cacambo thắng yên cương gấp cho hai con ngựa giống tốt của chủ.
- Hova vezetsz?	- Thầy ơi!
Hova megyünk?	- Hỡi Cunégonde yêu quý!
Mit csinálunk Kunigunda nélkül?	Chúng ta hãy chạy lẹ lên.
sóhajtá Candide.	Chúng ta sẽ tới đâu?
- Te már voltál Paraguayban?	- Mi đã từng ở xứ Paraguay chưa?
kérdé Candide.	- Cố nhiên là tôi đã ở đó.
Csodálatra méltó ez a kormányzat.	Chính phủ ấy thật là đáng khâm phục.
Hogy meg fognak örülni a lelki atyák, ha megtudják, hogy oly kapitányra bukkantak, ki érti a bolgár fegyvergyakorlatokat!"	Các cha sẽ hài lòng biết bao khi thấy một đại uý biết cách luyện binh theo lối Bảo Gia Lợi, đến giúp sức cho họ.
Mikor az első sorompóhoz értek, Cacambo tudtára adta az őrnek, hogy egy kapitány óhajtana beszélni a parancsnok úrral.	Hai thầy trò đến giới tuyến đầu tiên; Cacambo bảo với người lính gác rằng có một vị đại úy muốn xin nói chuyện với ngài tư lệnh.
Jelentést tesznek a főőrségen: egy paraguayi tiszt közli a parancs­nokkal az ujságot.	Trước hết chàng Ngây Thơ và Cacambo bị tước khí giới; người ta giữ hai con ngựa của họ lại.
Candide-ot és Cacambot először is lefegyverezték; elvezették a két andalúziai lovat.	Vị tư lệnh ngồi ở trong cùng, đầu đội mũ ba khía, áo sắn tay, gươm đeo bên hông, tay cầm đoản thương.
"És hol van most a főtisztelendő tartományi főnök ur?	- Thế bây giờ linh mục hàng tỉnh ở đâu?
kérdé Cacambo.	Viên trung sĩ đáp:
- De - jegyezte meg Cacambo - a kapitány ur, ki velem együtt majd elszédül az éhségtől, nem spanyol, hanem német.	Cacambo bèn nói: - Nhưng đại úy đây không phải người Y Pha Nho mà là người Đức.
Nem falatozhatnánk addig, mig a főtisztelendő főnök ur megérkezik?"	Viên Trung sĩ đi liền tới phòng của vị tư lệnh để thuật lại những lời của khách.
Pompás ennivaló volt arany edényekben feltálalva, mig a benszülöttek szabad ég alatt, fatálakból fogyasztották a kukoricát az izzó nap hevében.	Liền sau đó, người ta dẫn chàng Ngây Thơ vào trong một phòng của nhà lợp lá, trang trí bằng một cột cẩm thạch xanh, mạ vàng và những lồng cao nuôi đủ các thứ chim hiếm có.
Később a főtisztelendő parancsnok atya belépett a lugasba.	Một bữa ăn thịnh soạn được dọn ra, những món ăn đựng trong chén bằng vàng.
A parancsnok szép fiatal ember volt, piros szinü, telt arcu, fehér bőrü, ívelt szemöldökü, piros fülü, vérpiros ajku, büszke arckifejezésü, de büszkesége nem vallott sem spanyolra, sem jezsuitára.	Trong khi nông dân Paraguay ăn bắp nấu ở ngoài đồng nắng gắt, thì vị linh mục tư lệnh thết khách trong nhà mát ấy.
"Tehát német vagy?	- Vậy ra ông là người Đức sao?
kérdé a jezsuita németül.	- Vâng, thưa Cha, đúng như thế.
- Igenis, főtisztelendő atyám, mondá Candide." Ekkor mindketten nagy meglepetéssel és nem palástolható megindulással néztek egymásra.	Hai bên đối thoại với nhau bằng tiếng Đức và không nén được sự cảm động lẫn ngạc nhiên.
- "És Németországnak mely vidékéről való vagy?	- Ông ở tỉnh nào nước Đức?
kérdé a jezsuita.	Vị linh mục hỏi.
- Westphaliából, mondá Candide: a Thunder-ten-tronckh kastélyban születtem.	- Thưa Cha, tôi ở tỉnh Westphalie bẩn thỉu. Tôi sinh trưởng trong lâu đài của Nam tước Thunder-ten-tronckh.
- Óh egek!	- Trời ơi!
lehetséges ez?	Vị tư lệnh la lên.
kiáltott fel a parancsnok.	- Phép lạ kỳ diệu thay!
Miféle varázslat!	Chàng Ngây Thơ la tiếp.
- kiáltá Candide - Csakugyan te vagy az?	- Chính anh đấy sao?
kérdé a parancsnok.	Linh mục hỏi.
- Lehetetlen!	- Không thể như thế được.
te volnál az, tisztelendő atyám?	Lúc sau chàng Ngây Thơ nói tiếp:
téged, a báró ur fiát, téged, a paraguayi jezsuitát!	Nay lại thấy ngài là giáo sĩ dòng Tên ở Paraguay!
be kell vallani, hogy megfoghatatlan dolgok történnek e világon.	Thế giới thật lắm chuyện lạ.
Ó Pangloss!	Than ôi!
A parancsnok eltávolitotta a néger és paraguayi szolgákat, kik kristályserlegekben szolgálták fel az italokat.	Vị tư lệnh cho những tên nô lệ da đen và những kẻ hầu hạ bản xứ ra ngoài, để ông nói chuyện riêng với chàng Ngây Thơ.
"Még jobban elcsodálkozol, elérzékenyülsz és nem tudsz hova lenni a meglepetéstől, ha elárulom, hogy Kunigunda a te édes testvéred, kiről azt hitted, hogy fölmetszették a hasát, - a legjobb egészségnek örvend.	- Ngài sẽ còn ngạc nhiên gấp bội, xúc động trăm phần, nếu tôi báo tin ngài hay rằng cô Cunégonde em gái ngài vẫn còn sống, mạnh khỏe, trong khi có tin đồn cô bị mổ bụng.
- Hol van?	- Còn sống sao?
TIZENÖTÖDIK FEJEZET.	Chương XV
Hogyan ölte meg Candide a kedves Kunigunda bátyját?	CHÀNG NGÂY THƠ GIẾT ANH RUỘT CỦA NGƯỜI YÊU
"Sohasem felejtem el azt a rettenetes napot, melyben atyámat és anyámat megölték és húgo­mat megbecstelenitették.	Khi quân lính Bảo Gia Lợi rút lui, tôi không còn thấy người em gái đáng quý ấy đâu nữa.
Mikor a bulgárok visszavonultak, nem tudtuk többé fellelni drága testvéremet és atyámat, anyámat, engem, két szolgálónkat, három megfojtott kis gyermeket szekérre tettek, hogy a jezsuiták kápolnájába temessenek bennünket, mely két mértföldnyire volt őseim kastélyától.	Và chúng bỏ lên một cái xe bò, má tôi, ba tôi và tôi, cùng hai nữ tì, ba người tớ trai nhỏ bị cắt cổ chết, rồi đem chôn chúng tôi trong tiểu giáo đường dòng Tên, cách xa lâu đài của chúng tôi hai dặm.
Meggyógyitott és néhány hét mulva már egé­szen jól éreztem magam.	Thế là tôi được cứu khỏi chết và sau ba tuần tôi không thấy ông nữa.
A rendfőnök urnak fiatal német jezsuitákra volt szüksége.	Vị linh mục trưởng cần tuyển một số thanh niên dòng Tên người Đức.
A paraguai főnökök nem szivesen látják a spanyol jezsuitákat; jobban szeretik az idegeneket, mert azt gondolják, hogy ezekkel könnyebben rendelkezhetnek.	Vua xứ Paraguay tiếp dụng hết sức ít người Y Pha Nho dòng Tên; vua thích người ngoại quốc hơn để dễ bề làm chủ.
Megérkezésem után aldiakonná és hadnaggyá neveztek ki: ma ezredes és pap vagyok.	Lúc mới đến, tôi được vinh hạnh làm chức phó tế và mang lon trung úy.
Bátran szembeszállunk a spanyol király csapataival, jótállok érte, hogy kiátkozzuk és leverjük őket.	Nhưng có thật là Cunégonde em gái yêu quý của tôi, hiện nay ở dinh ông trấn thủ Buénos-Ayres không?"
Téged maga a Gondviselés küldött segitségünkre.	Cả hai người lại giàn giụa nước mắt.
De az én kedves Kunigundám csak­ugyan a szomszédságban van Buenos-Ayres kormányzójánál?"	- Như vậy, chắc là chúng ta sẽ thắng trận, kéo binh vào thành phố ấy giải thoát cho Cunégonde.
Candide esküvel bizonyitotta, hogy szent igaz, amit a leányról állitott.	- Đó là tất cả điều tôi mong ước, chàng Ngây Thơ đáp.
A báró egyre ölelgette Candide-ot, testvérének, megmentőjének nevezte.	- Mày muốn vậy sao, đồ hỗn xược, vị nam tước la lên.
"Ó - mondá a báró - kedves Candide-om, bárcsak együtt vonulnánk be, mint győztesek, a városba és kisza­baditanánk Kunigunda hugomat.	Mày lại dám trơ trẽn xin cưới em gái ta, một người có bảy mươi hai thế hệ quý tộc.
- Szemtelen!	Chàng đáp:
- felelt a báró - elég szemérmetlen volnál hozzá, hogy feleségül vedd az én hugomat, ki hetvenkét őssel dicsekedhetik!	- Thưa linh mục, tất cả những thế hệ quý tộc trên đời này không có nghĩa lý gì cả.
"Istenem, édes Istenem!	Quân sĩ sẽ vào đây.
Cacambo, ki a sorompó ajtajánál őrködött, hirtelen ott termett.	Hai thầy trò phóng ngựa chạy như bay khi Cacambo nói câu ấy.
TIZENHATODIK FEJEZET.	Họ cho ngựa ăn cỏ.
Milyen kalandjuk volt utasainknak két leánnyal, két majommal	Cacambo mời chủ ăn lót dạ và mình ăn trước để làm gương.
és az Oreillons-nevezetű vademberekkel?	Nói vậy, chàng không chịu ăn gì.
Candide és lakája már tul voltak a sorompókon; a táborban még senki sem vette észre a német jezsuita meggyilkolását.	Lúc mặt trời lặn, hai người đi lạc nghe những tiếng kêu nhỏ như tiếng phụ nữ.
Amig ezeket mondta, szakadatlanul evett.	- Cám ơn Chúa, chàng nói.
- A szeretőit?	- Tình nhân của hai cô?
Lehetséges volna?	Mi nói giỡn sao?
tréfát üzöl velem, Cacambo; nem tudom elhinni!	- Thầy ơi, thầy thấy cái gì cũng cho là lạ kỳ hết.
ők negyedrészben em­berek épp ugy, mint ahogy én negyedrészben spanyol vagyok.	Giống khỉ ấy có một phần tư là người cũng như tôi có một phần tư là người Y Pha Nho.
- Teringettét!	- Than ôi!
Cacamboval együtt meg­vacsorált; és mindketten, miután megátkozták a portugál főinkvizitort, Buenos-Ayres kor­mány­zóját és a bárót, a pázsiton elaludtak.	Hai thầy trò ăn bữa chiều tại đây; và cả hai, sau khi nguyền rủa viên pháp quan Bồ Đào Nha, thủ trấn Buenos-Ayres và ngài nam tước, họ lăn ra trên một khoảng đất rêu phong mà ngủ.
Jezsuita!	Cacambo nói:
Minden jól van!?	- Các ông ơi!
mondá, milyen emberek!	Chàng Ngây Thơ hỏi.
milyen szokások!	Và đi đâu đây?
Ha a véletlen szerencse folytán nem szurtam volna keresztül kedves Kunigundám bátyját, irgalom nélkül megettek volna.	Vả lại làm sao mà giải quyết được vấn đề rời bỏ thế giới mà ở đó cô Cunégonde đang sống?
TIZENHETEDIK FEJEZET.	Thật ra đến Cayenne không phải dễ.
Candide és lakája Eldorádóba érkeznek; mit látnak ott?	Hai người không biết rõ phải đi phía nào.
- Hogyan térjünk vissza, mondá Candide, és hova menjünk?	Thế là họ có dừa nuôi họ sống và nuôi hy vọng cho họ.
Hazámba menjünk?	Anh bảo với chàng Ngây Thơ:
- Menjünk Cayenne felé, mondá Cacambo; ott találhatunk franciákat, kik a világ minden tája felé mennek; ők majd segit­ségünkre lesznek: Isten szánakozni fog rajtunk."	Hai thầy trò chèo thuyền trên sông, giữa hai bên bờ có chỗ hoa cỏ mọc, có chỗ khô khan, cằn cỗi, có chỗ phẳng phiu, có chỗ gồ ghề, càng đi càng thấy khúc sông rộng hơn.
- Jól van, mondá Candide; bizzuk magunkat a Gondviselésre."	Nhưng chiếc thuyền đụng vào sườn núi, bể tan ra.
"No lám, mondá Candide, ez tán még Wesztpháliánál is többet ér." Cacamboval együtt az első faluban, mely utjokba esett, szárazföldre lépett.	Vài đứa trẻ trong làng bận quần áo bằng vóc, nhiễu, thêu vàng, rách tả tơi, đang chơi đáo ở đầu làng.
"Biztosan a királyi család nevelője," gondolta Candide.	Một hương chức bỗng ra kêu chúng vào trường học.
A kis nebulók rögtön ott hagyták a játékot, golyóikat és minden játékszerüket.	Chàng Ngây Thơ liền nói: "Ông này chắc là thầy dạy các hoàng tử".
Cacambo épp ugy meg volt lepve, mint Candide.	Cacambo cũng ngạc nhiên như chủ.
Amint Cacambo a kapuhoz közeledett, meghallotta, hogy perui nyelven beszélnek.	Cacambo dòm vào cửa để nghe người trong nhà nói chuyện; anh nhận ra họ nói tiếng Pérou là tiếng mẹ đẻ của anh.
Cacambo tolmácsolta Candide-nak a vendéglős beszédét és Candide ugyanoly csodálkozással és meghatottsággal hallgatta azt meg, mint ahogy Cacambo elmondta.	Xin lỗi hai ông, khi nãy chúng tôi đã cười vang vì thấy hai ông trả tiền bằng những thứ trải đường ở xứ chúng tôi.
"Miféle ország lehet ez, kérdé egyik a másiktól, melyről az egész világon nem tudnak semmit s melyben az emberi természet annyira különbözik a mi országunk szokásaitól!	Có lẽ hai ông không có tiền bản xứ, song điều ấy không cần thiết khi các ông đến ăn uống ở đây.
Mit láttak Eldorádóban?	Hai người nói với nhau:
Cacambo nagy kiváncsiságát nem palástolta el a vendéglős előtt.	Các việc ở đây khác hẳn hoàn toàn các việc ở xứ ta.
Az aggastyán kissé elpirulva igy szólt: "Hogyan kételkedhettek ebben?	Người Y Pha Nho biết rất mơ hồ về xứ này và đặt cho cái tên là xứ Eldorado.
Azt hiszitek, hogy mi hálátlanok vagyunk?" Cacambo tiszteletteljesen megkérdezte, milyen vallás van Eldorádóban.	Sau chót chàng Ngây Thơ vẫn ham thích siêu hình học nên nhờ Cacambo hỏi cụ già trong xứ này có đạo không?
- Csak egy Istent imádtok?	- Có thể có hai thứ tôn giáo chăng?
kérdé Cacambo, ki Candide kételyeit tolmácsolta.	Cacambo tiếp tục thông dịch những thắc mắc của chàng Ngây Thơ:
- Természetes, mondá az aggas­tyán, hogy nincs két Isten, sem három, sem négy: mondhatom, hogy mint más világból ide­szakadt emberek, nagyon különös kérdéseket tesztek."	- Dân chúng ở đây chỉ thờ một Thượng đế chăng? - Bề ngoài thì như thế, không có hai hay ba, hay bốn tôn giáo.
Ám Candide fáradhatatlanul tovább kérdezte az öreget; kiváncsi volt rá, hogyan imádják az Istent Eldorádóban?	Tôi thú thật rằng thế giới của các ông nêu ra nhiều vấn đề khá đặc biệt về tôn giáo.
"Sehogysem imádjuk, mondá a jóságos és tiszteletre méltó bölcs, nincs mit kérni tőle, mindennel elárasztott, amire szükségünk van; folytonosan köszönetet mondunk neki."	Chàng Ngây Thơ không ngớt hỏi cụ già đáng kính ấy nhiều điều khác nữa; chàng muốn biết dân chúng ở Eldorado có cầu nguyện Thượng đế không?
- Hogyan, nektek nincsenek barátaitok, kik tanitanak, vitatkoznak, kormányoznak, büvész­kednek és akik megégetik az embereket, ha más véleményen vannak?	Quý quốc không có những thầy tu để giảng đạo, để tranh luận, để cai trị tín đồ, và để hỏa thiêu những người không cùng ý kiến sao?
Candide egészen extázisba jött e beszélgetés alatt és ezt mondogatta magában: "Ez az állapot ugyancsak különbözik a westphaliai és a báró ur kastélyában uralkodó állapotoktól; ha Pangloss barátunk látta volna Eldoradót, bezzeg nem mondta volna, hogy a Thunder-ten-tronckh kastély a legszebb a világon; bizony jó, ha utazgat az ember."	Chàng Ngây Thơ nghe những lời cụ già nói, thấy rất khoái chí và tự nhủ thầm: "Thật là khác hẳn vùng Westphalie và tòa lâu đài của ngài nam tước: Nếu ông Pangloss đã đi thăm xứ Eldorado thì ông đã không nói rằng lâu đài của nam tước đẹp nhất trần gian; thật là cần phải đi cho biết đó biết đây."
Candide és Cacambo kocsiba ültek, röpült velök a hat kos és négy óra sem pergett le, már a királyi palotában voltak, mely a főváros tulsó részén feküdt.	Chàng Ngây Thơ và Cacambo lên xe ra đi, sáu con trừu kéo xe chạy như bay, chưa đầy bốn tiếng đồng hồ đã đến cung điện nhà vua, ở đầu thủ đô.
A bejárat kétszázhusz lépés magas és száz lépés széles volt; lehetetlen leirni, hogy milyen anyagból készült.	Cổng vào cao hai trăm hai mươi bộ và rộng một trăm bộ; không thể biết được cổng ấy làm bằng chất gì.
Világos, hogy nagyon is fölötte állt annak a kavicsnak és homoknak, melyet mi aranynak és drágaköveknek hivunk.	Chỉ có thể nói rằng nó được làm bằng một thứ đắt giá hơn rất nhiều những cục đá, sỏi và cát, gặp trên đường mà người ta gọi tên là: vàng bạc, châu báu, kim cương.
Mikor a trónterem felé közeledtek, Cacambo megkérdezte egy magasrangu udvarnoktól, hogy térdre kell-e borulni vagy hasra kell-e esni ő felsége előtt; kezöket a fejökre vagy az ülepükre kell-e tenni?	Đi gần đến ngai vàng, Cacambo hỏi một sĩ quan phải chào ra sao khi bái yết long nhan: Phải quỳ gối hay nằm áp bụng xuống đất; phải chắp tay lên đầu hay để đằng sau ót; phải liếm bụi ở dưới bệ ngọc hay phải làm cử chỉ gì khác, tóm lại nghi lễ phải như thế nào?
fel kell-e nyalni a szoba porát, szóval: milyen a szokásos szertartás?	Vị sĩ quan đáp: "Theo thông lệ thì phải ôm lấy vua và hôn hai bên".
"Az a szokás, felelte a magasrangu udvarnok, hogy megölelik a királyt s mindkét arcát megcsókolják."	Theo lời dặn ấy, chàng Ngây Thơ và Cacambo thi hành đúng theo thủ tục.
Miután a délután folyama alatt a város ezredrészét bejárták, visszavezették utasainkat a király­hoz.	Sau khi mất trọn buổi chiều, đi xem được một phần ngàn của thành phố, người ta đưa hai khách ngoại quốc trở về cung điện nhà vua.
Cacambo tolmácsolta Candide-nak, a király szellemességeit, melyek más nyelvre forditva is megtartották eredeti zamatjukat.	Cacambo thông dịch những lời vàng ngọc của nhà vua nói với khách và dù là dịch lại, những lời ấy vẫn nguyên tính chất là lời vàng ngọc.
De ha mindenáron el akartok menni, parancsot adok mérnökeimnek, hogy készitsenek egy oly gépet, mely kényelmesen átszállit benneteket.	Vì thần dân của tôi đã có lời nguyền không ra khỏi xứ và họ khôn ngoan, không chịu phá lời nguyền ấy.
Candide-ot és Cacambot feltették a gépre; feltettek két nagy piros juhot felnyergelve és felkantározva, hogy azokra üljenek, ha majd tul lesznek a hegyeken, azonkivül husz kos élelmi­szerekkel volt megrakva, harmincat az ország legértékesebb kincseivel terheltek meg, ötvenet arannyal, drágakövekkel és gyémántokkal.	Hai con trừu lớn đã được thắng yên cương đầy đủ để dùng thay ngựa cho hai du khách, một khi đã vượt qua núi đặt chân xuống mặt đất; hai chục con trừu loại chuyên chở được chất đầy lương thực trên lưng; ba chục con khác chở những vật quý, lạ, làm quà cho hai du khách; năm chục con nữa chở những vàng, ngọc, kim cương.
A király gyöngéden átölelte a két világ­járót.	Nhà vua dịu dàng ôm hôn hai chàng lãng tử.
TIZENKILENCEDIK FEJEZET.	Chàng Ngây Thơ nhủ thầm:
Candide ismeretséget Martinnal?	HAI NGƯỜI ĐẾN SURINAM; CHÀNG NGÂY THƠ LÀM QUEN VỚI MARTIN
Utasaink első napjai elég kellemesen teltek el.	Ngày thứ nhất hai thầy trò cảm thấy thật là dễ chịu.
Felbátoritotta őket az a tudat, hogy több kincs volt birtokukban, mint amennyit Ázsia, Európa és Afrika együtt felmutathatnak.	Họ được kích thích bởi ý nghĩ rằng họ sẽ giàu có lớn; của cải của họ sẽ hơn cả những kho tàng ở Á châu, u châu, Phi châu gộp lại.
Candide egészen oda volt az örömtől és ezerszer felkarcolta a fákra Kunigunda nevét.	Chàng Ngây Thơ khoái trá, thỉnh thoảng đứng lại khắc tên Cunégonde lên cây.
Fáradságunk véget ér és boldogságunk kezdetéhez jutottunk."	Chúng ta đã khó nhọc tới cực độ, bây giờ bắt đầu thấy có may mắn được sung sướng rồi đấy.
Amint a város felé közeledtek, egy négert láttak a földön elterülve, kinek csak fél-ruhája volt, azaz egy kék vászon alsónadrágja; a bal lába és a jobb keze hiányzott e szerencsétlen ember­nek.	Đi tới gần thành phố này họ được gặp một người mọi da đen nằm dài trên mặt đất, chỉ có được một cái quần cụt bằng vải xanh che thân, con người khốn khổ này lại mất một chân trái và một bàn tay phải.
- Gazdámat várom, Vanderdendur urat, a világhirü kereskedőt, felelé a néger.	- Tôi chờ chủ tôi là ông Vanderdendur, một nhà buôn lớn.
- Vanderdendur ur bánt el veled ily kegyetlenül, kérdezte Candide.	- Phải chăng ông Vanderdendur đã đối xử với anh như thế này?
nem tudom, megalapitottam-e az ő szerencséjöket, de ők nem teremtették meg az enyémet; a kutyák, majmok és papagályok ezerszerte boldogabbak nálunk; a hollandiai fetisek, kik a keresztény hitre téritettek, minden vasárnap azt prédikálják, hogy valamennyien, fehérek és feketék, Ádám gyermekei vagyunk.	Những mục sư Hà Lan là người đã làm cho chúng tôi theo đạo, Chủ nhật nào cũng nói với chúng tôi rằng tất cả mọi người đều là con của ông Adam, dầu là người da trắng hay da đen.
- Ó Pangloss!	- Ông Pangloss ơi!
- Mi az az optimizmus?	- Chủ nghĩa lạc quan là cái gì vậy?
kérdé Cacambo.	Cacambo hỏi.
- Ó jaj!	- Than ôi!
mondá Candide, valami olyan őrület, mely azt mondatja velünk, hogy minden jól van, midőn minden rosszul van."	Và chàng chảy nước mắt, nhìn lại người mọi da đen; chàng vừa khóc vừa đi vào thành phố Surinam.
És patakként hulltak a könnyei, amint a négerre tekintett és sirva értek Surinamba.	Người mà họ hỏi được tin ấy chính là một chủ tàu Y Pha Nho.
Az a személy, akihez fordultak, éppen egy spanyol hajóskapitány volt, ki fogadkozott, hogy tisztességesen megfelel a kivánságuknak; találkát adott nekik egy korcsmá­ban; Candide és Cacambo bevárták őt a megbeszélt helyen a kosokkal.	Chàng Ngây Thơ và người thuộc hạ trung tín Cacambo đến chờ ông ta ở đây cùng với hai con trừu.
Candide, kinek minden a száján is volt, ami a szivén, elmesélte a spanyolnak minden kalandját és bevallotta neki azt is, hogy Kunigunda kisasszonyt szeretné megszöktetni.	Chàng Ngây Thơ vốn tính bộp chộp kể lại chuyện cho người chủ tàu nghe những chuyến phiêu lưu của chàng và thú thật với ông rằng chàng muốn giải thoát cho cô Cunégonde.
Cacambonak megtetszett a bölcs tanács, ámbár nagyon elszomoritotta, hogy el kell válnia jó gazdájától, ki benső barátjának tekintette őt; de az öröm, hogy segithet rajta, felülmulta a fájdalmat.	Anh thấy thất vọng phải xa chủ anh, nay đã trở thành người bạn thân thiết nhưng nghĩ đến việc có thể giúp ích cho bạn, anh lại vui mừng và trấn áp được sự đau lòng ly biệt.
Cacambo még e napon utrakelt; derék fickó volt ez a Cacambo.	Cacambo đi liền ngày hôm ấy: Thật là một người tận tâm với bạn.
Candide még néhány napon Liszabonban maradt és egy másik hajóskapitányra várt, aki el­vinné őt Olaszországba, a két megmaradt kossal együtt.	Chàng Ngây Thơ còn ở lại thành phố Surinam ít lâu nữa, để chờ gặp một chủ tàu khác chịu chở chàng đến nước Ý cùng với hai con trừu còn lại.
Szolgákat fogadott és mindent bevá­sá­rolt, ami egy hosszu utazásra szükséges; végre Vanderdendur ur, egy nagy hajó tulajdonosa, jelentkezett nála.	Chàng thâu dụng vài người đầy tớ và mua tất cả những gì cần thiết cho một cuộc hành trình khá dài.
"Mennyiért visz el Velencébe, kérdezte meg ezt az embert, engem, szolgái­mat, málháimat és ezt a kost?" A hajótulajdonos tizezer piasztert kért.	Thằng cha này đã ưng chịu cái giá mười ngàn một cách dễ dàng thì hắn cũng có thể trả hai chục ngàn." Nghĩ vậy, y trở lại nói với chàng Ngây Thơ rằng y chỉ có thể đưa chàng đến Venise với cái giá hai chục ngàn, chàng Ngây Thơ liền đáp:
Candide nem alkudott.	- Thì ông sẽ có đủ hai chục ngàn!
"Ó, mondá magában a ravasz Vanderdendur, ez az idegen egyszerre megadja a tizezer piasztert?!	"Hừ, tay lái buôn nghĩ thầm, thằng cha này bằng lòng trả hai vạn cũng dễ dàng như một vạn".
ugy látom, nagyon gazdag." Egy pillanat mulva visszatért és kijelentette, hogy húszezren alul nem szállitja át őket.	Hắn trở lại và nói rằng nếu kém ba vạn thì hắn không thể chở chàng Ngây Thơ đến Venise được, chàng Ngây Thơ trả lời:
"Megadom!	-Thì ba vạn!
"Legyen tehát harmincezer, felelte Candide.	Chàng trả trước cho y đủ số tiền.
Candide eladott két kis darab gyémántot, melyek közül a kisebb is többet ért, mint az egész összeg, melyet a hajótulajdonos követelt: előre ki is fizette.	Chàng Ngây Thơ nhìn theo chiếc tàu đi mau lẹ, rồi mất hút, chàng thất thần và ngạc nhiên: "Trời ơi!
Először a két kost tették hajóra: Candide is arra csónakázott, hogy a révnél maga is hajóra szálljon.	Đây là một vụ lường gạt xứng đáng với con người ở Cựu Thế giới".
kiáltott fel, ez a gazság igazán az ó-koriakhoz méltó." Fájdalomba merülve evezett vissza a partra; nem csoda: hisz annyi kincset vesztett el, amennyivel husz uralkodó szeren­cséjét meg lehetne alapitani.	Chàng đến văn phòng ông thẩm phán Hà Lan; trong lúc bối rối chàng gõ cửa khá mạnh; vào trong phòng vị thẩm phán, chàng trình bày việc vừa xảy ra và nói lớn tiếng hơn thường lệ.
A biró azzal kezdte, hogy tizezer piasztert fizettetett vele, amiért oly nagy zajt csapott: azután türelmesen végighallgatta, megigérte, hogy mihelyt a kereskedő visszatér, megvizsgálja ügyét és ekkor még tizezer piasztert fizettet vele a kihallgatásért.	Nhưng lần này thái độ lạnh lùng của ông tòa và lòng gian xảo của ông chủ tàu đã đoạt của của chàng, làm cho chàng phải chìm đắm trong một nỗi buồn u uất.
A pályázók oly tömege jelentkezett, hogy egy hadihajón sem fért volna el.	Người đến kiếm chàng xin đi rất đông, nếu thuê cả một cái tàu chở cũng không hết.
A tanácskozás egészen hajnali négy óráig tartott.	Buổi nói chuyện kéo dài đến tận bốn giờ sáng.
"Pangloss, mondta magában, ugyancsak zavarba jönne, ha rendszerét be kellene bizonyitania; bárcsak itt lehetne.	Sau đó chàng quyết định chọn một nhà thông thái bạc phước đã làm việc mười năm cho các thư quán ở Amsterdam.
Az biztos, hogy csak Eldorádóban folynak jól a dolgok, és sehol másutt a világon."	Chàng xét ra không còn có gì đáng chán ngán bằng cái nghề ấy.
Végül egy szegény tudós javára döntötte el a dolgot, ki tiz esztendeig dolgozott az amszter­dami könyvkereskedések részére.	Nhà thông thái này đã bị vợ đoạt hết của cải, bị con trai đánh đập và bị mất người con gái vì cô đi theo một tên Bồ Đào Nha.
Ugy találta, hogy nincs a világon oly mesterség, melytől jobban meg lehetne undorodni.	Ông lại vừa mất việc làm, một việc mà ông nhờ đó sống lay lắt bấy lâu.
A vetélytársak mind ugy érezték, hogy Candide nagy igazságtalanságot követett el velök szemben; Candide azonban mindegyiknek száz piasztert adott s ezzel megnyugtatta őket.	Sau khi nhà thông thái được lựa chọn, những người khác tỏ vẻ bất bình vì họ tưởng mình còn khổ hơn ông, mà không được lựa chọn, chàng Ngây Thơ làm dịu lòng phẫn uất của họ bằng cách tặng mỗi người một trăm đồng bạc.
HUSZADIK FEJEZET.	Chương XX
Mi történt Candide-dal és Martinnal a tengeren?	ĐIỀU GÌ XẢY RA TRÊN BIỂN VỚI CHÀNG NGÂY THƠ VÀ MARTIN
Az agg tudós tehát, kinek Martin volt a neve, Bordeaux felé hajózott Candide társaságában.	Nhà thông thái già Martin thế là được xuống tàu đi Bordeaux với chàng Ngây Thơ.
"És te, Martin mester, mondá a tudósnak, mit gondolsz minderről?	- Thế nào, ông Martin, ông có ý kiến gì về các câu chuyện của tôi?
mi a véleményed az erkölcsi és fizikai rosszról?	Ông nghĩ sao về cái khổ vật chất và cái khổ tinh thần?
- Uram, felelé Martin, papjaim azzal vádoltak, hogy szociniánus vagyok, holott igazság szerint manicheus vagyok.	- Thưa ông, các mục sư của tôi tố cáo tôi theo phái Socin.
- Egyedül én vagyok az, mondá Martin; hiába, nem tudok máskép gondolkozni.	Hiện nay đâu còn tín đồ giáo phái ấy? - Còn có tôi là tín đồ.
- Biztosan az ördög bujt beléd, mondá Candide.	Tôi không thể nào tin tưởng khác được. - Ông bị ma quỷ ám ảnh sao?
Még nem láttam olyan várost, mely ne kivánta volna a szomszéd város pusztulását, sem olyan családot, mely ne akart volna egy másik családot megsemmisiteni.	Tôi chả thấy thành phố nào mà lại không muốn tàn phá thành phố bên cạnh, chưa bao giờ nhìn thấy một gia đình nào mà lại không muốn tiêu diệt gia đình khác.
A gyöngék mindenütt átkot szórnak a hatalmasokra, kik előtt csusznak-másznak, a hatalmasok pedig mindég ugy bánnak velök, mint a nyájakkal, melyeknek gyapját és husát áruba bocsátják.	Ở các xứ trên Trái đất này, kẻ yếu ghét cay ghét đắng kẻ mạnh mà vẫn mọp xuống trước mặt những kẻ mạnh; còn kẻ mạnh coi kẻ yếu như bầy trừu để lấy lông và đem bán thịt.
A titkos fájdalmak még a nyilvánvaló nyomoruságnál is rettentőbbek... Egy szóval: én annyit láttam és tapasztaltam, hogy manicheus lettem.	Tóm lại tôi đã thấy việc đời quá nhiều, đau khổ quá nhiều đến phải tin tưởng ở lý thuyết thiện ác cộng đồng.
- De azért mindenütt lehet találni valami jót, jegyezte meg Candide.	Chàng Ngây Thơ cãi: - Tuy vậy khắp nơi còn ít nhiều điều tốt.
- Lehet, mondá Martin, de én kételkedem benne."	- Có thể có, song tôi không biết điều tốt ấy ở đâu?
Mindenki messzelátójához nyult.	Mỗi người lấy viễn kính ra nhòm.
Két hajót pillantottak meg, mely körülbelül három mértföldnyi távolságból támadt egymásra: a szél mindkettőt olyan közel sodorta a francia hajóhoz, hogy kényelmesen végig lehetett nézni a harc kimenetelét.	Người ta thấy hai tàu bắn nhau, cách xa nhau chừng ba dặm; và gió thổi nên hai tàu ấy bị đẩy tới gần chiếc tàu Pháp, người ta lại càng thấy rõ hơn hai chiếc tàu chiến.
Végül az egyik hajó a másiknak oly hatalmas sortüzet adott, hogy az utóbbi léket kapott a fenekén.	Sau chót, một chiếc tàu bắn một phát trúng phóc sườn tàu địch, làm cho nó bắt đầu chìm, chàng Ngây Thơ và ông Martin thấy rõ chừng trăm người trên boong thượng.
"No, látod, mondá Martin, hogy bánnak az emberek egymással.	- Coi đó! Con người đối xử với nhau như thế đó!
- Bizony valami ördögi van a dologban" mondá Candide.	- Thật là có cái gì ma quái trong vụ này. Chàng Ngây Thơ đáp.
Egyike volt a kosoknak.	Thì ra là một con trừu lông đỏ.
Candide jobban megörült annak, hogy ezt az egy kost megtalálta, mint amennyire lesujtotta, hogy százat elvesztett, mely Eldorádó drága gyémántjaival volt meg­rakva.	Chàng Ngây Thơ vui mừng khi thấy lại con vật ấy, lòng vui còn lớn hơn cả nỗi buồn khi mất trăm con chở kim cương và bảo vật, lấy được từ xứ Eldorado.
A francia kapitány rögtön észrevette, hogy a győztes hajó parancsnoka spanyol nemzetségü volt, az elmerülté pedig egy holland kalóz: az, amelyik megrabolta Candide-ot.	Vị thuyền trưởng Pháp nhận ra rằng thuyền trưởng chiếc thuyền bắn chìm chiếc tàu địch là một người Y Pha Nho, còn thuyền trưởng chiếc tàu chìm là một tên cướp biển Hà Lan; chính tên này đã đoạt bảo vật của chàng Ngây Thơ.
A végtelen gazdagság, melyet ez a gazember megkaparitott, vele együtt a tengerbe veszett és csak az az egyetlen kos menekült meg.	Tất cả các bảo vật ấy chìm xuống biển theo tên cướp; chỉ còn một con trừu sống sót, chàng Ngây Thơ nói với Martin:
Tizenöt napig szakadatlanul vitatkoztak és a tizenötödik napon is csak odáig jutottak, ameddig az első napon: de fődolog, hogy mégis beszélgettek, eszmecserét folytattak és ezzel vigasztalták egymást.	Chiếc tàu Pháp cùng chiếc tàu Y Pha Nho tiếp tục cuộc hành trình trong khi chàng Ngây Thơ và Martin tiếp tục đàm luận, kéo dài cả mười lăm ngày mà kết quả thì cũng như ngày đầu tiên.
Candide gyöngéden megcirogatta kosát s azt mondta: "Ha téged megtaláltalak, biztosan megtalálom Kunigundát is."	Nhưng cuối cùng, hai người cũng được trò chuyện với nhau, trao đổi ý kiến, an ủi nhau.
HUSZONEGYEDIK FEJEZET.	Chàng Ngây Thơ vuốt ve con trừu:
Candide és Martin Franciaország partjai felé	- Ta đã tìm thấy mi thì ta có thể gặp lại Cunégonde.
Végre meglátták Franciaország partjait.	Đã thấy bờ biển nước Pháp, chàng Ngây Thơ hỏi Martin:
"Voltál már valaha Franciaországban?	- Ông có bao giờ đến nước Pháp chưa?
- Hát Párist láttad-e már?	- Nhưng ông Martin ơi, ông đã thăm Paris chưa?
- De hogy el ne felejtsem: te is azt hiszed, hogy a föld eredetileg tenger volt, mint ahogy a hajóskapitány vastag könyvében meg van irva?	- À này, ông Martin, ông có tin hay không rằng Trái đất nguyên thuỷ chỉ là một đại dương, như là cuốn sách của vị thuyền trưởng đã nói?
- Semmit sem hiszek el belőle, mondá Martin, valamint a többi ábrándos föltevésekből sem, amiket egy idő óta terjesztenek.	- Tôi không thể nào tin được, cũng như không thể tin bao nhiêu chuyện ảo tưởng mà ít lâu nay người ta vẫn tuyên truyền.
- De végre is mi célból lett teremtve a világ?	- Chẳng biết Trái đất này được hình thành vì cứu cánh nào?
kérdé Candide.	Chàng Ngây Thơ hỏi.
- Hogy meg­bolonduljunk, válaszolá Martin.	- Để làm cho chúng ta điên hết. Martin đáp.
- Nem csodálkozol-e szerfelett, folytatta a kérdezősködést Candide, ama két leánynak a majmok iránt érzett szerelmén az Oreillonok országában, a kikkel való kalandomat elmeséltem?	- Ông có tin chuyện hai phụ nữ yêu loài khỉ ở xứ rợ Oreillon, như là tôi đã kể cho ông nghe không? - Tôi không thấy gì kỳ lạ trong sự đam mê của hai phụ nữ ấy.
- Egy cseppet sem csodálkozom rajta, mondá Martin; nem látom ezt a szenvedélyt különösnek; hiszen annyi rendkivüli dolgot láttam már!	Tôi đã từng thấy nhiều việc kỳ lạ hơn nên không cho chuyện ấy là lạ kỳ.
- Mit gondolsz, kérdé Candide, vajjon az emberek mindég igy mészárolták egymást, mint manap­ság?	- Ông có tin là con người cứ tàn sát lẫn nhau mãi mãi như ngày nay không?
mindig ily hazugok, gazemberek, álnokok, hálátlanok, rablók, csélcsapok, gyávák, irí­gyek, inyencek, részegesek, kapzsik, dicsvágyók, vérengzők, rágalmazók, tobzódók, fanatiku­sok, képmutatók és ostobák voltak?	Ông có tin họ còn mãi mãi là những kẻ ăn cắp, gian xảo, dối trá, bội bạc, ăn cướp, nhu nhược, lả lướt, hèn hạ, tham lam, say sưa, biển lận, đa sát, phỉ báng, trác táng, cuồng tín, giả đạo đức và ngu dại?
- Mit gondolsz, felelé Martin, vajjon a sólymok mindég megették a galambokat, ha rájuk bukkantak?	Martin hỏi lại: - Ông có tin rằng diều hâu luôn luôn ăn thịt chim bồ câu khi chúng bắt gặp?
- Kétségkivül, mondá Candide.	- Chắc hẳn là thế.
- Nos, mondá Martin, ha a sólymoknak mindég egyforma volt a természetök, miért tételezed fel, hogy az emberek természete változott?	- Loài diều hâu giữ mãi cá tính, thì tại sao ông mong loài người thay đổi cá tính được. - Ồ!
Ilyen okoskodások közben értek Bordeauxba.	Trong khi nói đến đây, tàu đã tới bến Bordeaux.
HUSZONKETTEDIK FEJEZET.	Chương XXII
Mi történt Candide-dal és Martinnal Franciaországban?	BIẾN CỐ XẢY ĐẾN CHO HAI NGƯỜI Ở NƯỚC PHÁP
Azonban az utasok, kikkel Candide az utszéli korcsmákban találkozott, valamennyien azt mondták: "Megyünk Párisba" Látva ezt az általános buzgóságot, Candide-nak is kedve kerekedett a fővárosba menni: azért még nem kell nagy kitérőt tenni Velencétől.	Giải thưởng rốt cuộc được phát cho một nhà thông thái miền Bắc đã chứng minh bởi A hơn B, kém C, bị phân chia bởi Z nên con cừu phải đỏ và chết vì bệnh đậu cừu.
Martin megjegyezte:	Martin nói với chàng Ngây Thơ:
"Emlékszem, hogy én is beteg voltam Párisban első ittlétem alkalmával, de mivel szegény voltam, nem voltak mellettem se barátok, se apácák, sem orvosok és - mégis meggyógyul­tam."	- Tôi còn nhớ lần thứ nhất tôi đến Paris, cũng bị đau, song khi ấy tôi nghèo, không ai đến săn sóc cho tôi cả, không có y sĩ, không có bạn thân, không có bà mộ đạo. Vậy mà tôi cũng hết bệnh.
A civakodás elmérge­se­dett s Martin megragadta a papot vállánál fogva és irgalmatlanul kidobta; ebből nagy botrány lett, melyről jegyzőkönyvet is vettek fel.	Martin hích vai và đuổi cổ lão thầy tu một cách thô bạo, đó là nguyên nhân của một vụ bê bối lớn mà người ta phải lập biên bản. Chàng Ngây Thơ khỏi bệnh.
Candide elcsodálkozott rajta, hogy soha sem volt disznója, de Martin nem csodálkozott ezen.	Chàng rất ngạc nhiên là khi chia bài không bao giờ con "ách" đến với chàng.
Ámde egy gáncsoskodó, aki mellette ült, igy szólt hozzá felvonásközben:	Tuy vậy chàng cũng phải khóc khi xem vài màn diễn xuất hay.
- Tisz­te­lendő uram, kérdé Candide az apáttól, körülbelül hány szindarabja van Franciaországnak?	Tác giả không biết một tiếng Ả Rập vậy mà tích tuồng lại là chuyện xảy ra ở nước Arabie.
- Öt vagy hatezer, feleli az apát.	- Thưa ngài, tại Pháp có bao nhiêu vở kịch?
- Ez sok, jegyezte meg Candide, és hány jó van köztük?	- Năm ngàn hay sáu ngàn vở. - Thế thì quá nhiều đó.
- Tizenöt vagy tizenhat, válaszolt a másik.	Có bao nhiêu vở hay? - Mười lăm hay mười sáu vở.
- Ez sok, mondá Martin."	- Cũng nhiều quá đấy.
"Az a vidékektől függ, mondá az apát; vidéken a korcsmába viszi őket az ember; Párisban megbecsülik őket, mig szépek s ha meghaltak, a szemétdombra jutnak.	- Phải phân biệt từng trường hợp: ở các tỉnh, người ta mời họ đi ăn uống; ở Paris người ta tôn trọng họ khi họ còn đẹp; và liệng họ ra đường, khi họ đã chết.
- A királynők a szemétdombon!	- Nữ hoàng mà bị liệng xác ra đường sao?
kiáltott fel Candide.	Martin xen lời vào.
- Ez igen nagy udvariatlanság, mondá Candide.	Martin đáp: - Biết làm sao bây giờ?
- Igaz, hogy Párisban mindég kacagnak?	- Phải chăng người ta hay cười cợt ở Paris?
kérdé Candide.	Vị tu viện trưởng đáp:
- Igen, de néha dühükben nevetnek, mondá az apát; mert mindenért hangos kacagással panaszkodnak; és a legutálatosabb dolgot is kacagva hajtják végre.	- Phải, nhưng người ta vừa cười vừa muốn điên lên được: Người ta phàn nàn đủ mọi thứ, với những trận cười nổ vang, kể cả trận cười khi làm những việc bỉ ổi nhất.
- Mi az a zug-irodalmár, érdeklődött Candide.	- Thế nào là kẻ "bán văn" vô loại?
- Egy könyv­gyártó, egy Fréron, válaszolt az apát."	- Nó là một kẻ viết cho đầy giấy, một con rắn độc, kiểu như tên Fréron.
Ily eszmecserét folytattak Candide, Martin és a perigordi apát a kijárat mellett, miközben nézték a szinházból kitóduló közönséget.	 Chàng Ngây Thơ và Martin cùng vị tu viện trưởng đàm luận như vậy khi xuống thang ra về, nhìn theo đám khán giả.
- Ámbár égek a vágytól, mondá Candide, hogy viszontlássam Kunigunda kisasszonyt, mégis nagyon szeretnék Clairon kisasszonnyal együtt vacsorálni, mert bámulója lettem!	Chàng Ngây Thơ nói: - Dầu tôi nóng lòng gặp cô Cunégonde, tôi cũng muốn mời cô đào Clairon dùng bữa tối với tôi, vì tôi thấy cô thật khả ái.
A lakájok a maguk nyelvén mondogatták egymásnak: Ez alighanem valami angol milord.	Bà gọi người đem một bộ bài, một cái ghế cho chàng Ngây Thơ ngồi.
"Olvastad-e, kérdé a perigordi apát, Gauchat urnak, a theologia dokto­rá­nak könyvét?	Bữa ăn diễn tiến thông thường như các bữa ăn khác ở Paris.
- Igen, felelte az egyik vendég, de nem voltam képes bevégezni; mert bár rengeteg szemérmetlen irodalmi fércmunkánk van, de egyik sem közeliti meg Gauchat urnak, a theologia doktorának arcátlanságát; annyira megundorodtam ezektől az utálatos könyvektől, melyek valósággal elárasztanak már bennünket, hogy kénytelen voltam ráadni a fejem a fáraó játékra.	Trước hết người ta yên lặng; kế đến là những tiếng xì xào, nghe không rõ; rồi đến những câu vui đùa phần nhiều vô vị, những tin thất thiệt, những lời lí luận sai lầm, một chút chính trị và nhiều lời nói xấu, phỉ báng; người ta cũng nói đến cả những sách mới xuất bản. Ông tu viện trưởng hỏi:
- És mit szól Trublet esperes ur Vegyes irataihoz, kérdé az apát.	- Các ông có thấy cuốn tiểu thuyết của cái ông Gauchat, tiến sĩ triết học chưa?
- Ó, szólalt meg Polignac asszony, az az unalmas halandó!	- Dạ đã, một thực khách đáp, nhưng tôi không thể đọc hết được.
milyen fontoskodással mond el olyan dolgot, melyekről nem is érdemes megemlékezni!	Tôi đã chán ngấy những sách đáng ghét ấy, xuất bản tràn ngập; chán đến nỗi tôi đi đánh bạc còn hơn.
ó mint utálom!...	Đọc buồn chết đi được!
De többet már nem fog bosszantani; teljesen elég, ha néhány lapot elolvastunk az esperes ur irásaiból."	Thật tôi chán ngấy ông ta; nhưng tôi không còn phải chán ngấy nữa vì tôi chỉ đọc có vài trang thôi.
Volt az asztalnál egy tudós és választékos izlésü ember, ki mindenben megerősitette azt, amit a márkinő állitott.	Tại bàn ăn có một người ra vẻ thông thái và ý thức; ông ta nói vài tiếng ủng hộ luận điệu của bà hầu tước.
"Ha valaki, tette hozzá, nem veszi figyelembe mind e szabályokat, irhat ugyan egy-két olyan darabot, melyet a szinházban megtapsolnak, de sohasem lesz igazán jó iró.	- Ai mà không tôn trọng các nguyên tắc ấy có thể sáng tác một hai vở kịch được hoan nghênh trên sân khấu nhưng không bao giờ được liệt vào hạng các văn nhân danh tiếng.
Kevés, igazán jó tragédia van, némelyikök nem egyéb, mint csengőn rimelő és jól megirt idyll párbeszédes formában: némelyek politikai okoskodások, melyek elaltatnak vagy szóhalmozások, melyek visszataszitanak; van olyan, mely nem más mint barbár stilusban megirt hagymázos álom, az istenekhez intézett szakadozott mondatokban, mert telve hamis tételekkel, dagályos köz­helyekkel, nem képes az emberekhez szólni."	Có rất ít vở bi kịch hay: Có những vở hay về đối thoại; những vở khác lại chỉ có những lý luận chính trị, làm cho khán giả buồn ngủ; những vở kịch khác nữa tả những ảo mộng, viết bằng lối văn thô lỗ, với những lời nói dài dòng, những tiếng kêu gọi thần linh, những lời khuyên răn sai lầm, những ý tưởng tầm thường, những sáo ngữ.
"- Mily nagy ember!	Chàng Ngây Thơ bèn nói:
- E szennyfoltokat maguk az emberek okozzák, jegyezte meg Candide, és nem képesek azt elkerülni.	- Nhà hiền triết của ông coi thường thiên hạ quá! Martin xen lời vào.
- Akkor hát nem az ő hibájok," mondá Martin.	- Những vết đen ấy là do con người gây ra.
A játékosok nagy része nem értette ezt az okoskodást és ivott; Martin vitatkozott a tudóssal, Candide elmesélte néhány kalandját a ház úrnőjének.	Martin thì lý luận với nhà thông thái, chàng Ngây Thơ thì thuật lại một phần các cuộc phiêu lưu của mình cho nữ gia chủ nghe.
Vacsora után a márkinő bevezette Candide-ot kis szobájába s leültette egy diványra.	Sau bữa ăn, bà hầu tước dẫn chàng Ngây Thơ vào văn phòng của bà, mời chàng ngồi trên một cái ghế dài và hỏi:
"Nos - igy szólt hozzá - még mindég őrülten szereted Thunder-ten-tronckh Kunigunda kis­asszonyt?	- Vậy là ông vẫn còn yêu tha thiết cô Cunégonde, dòng dõi nam tước Thunder-ten-tronckh? - Thưa bà vâng.
- Igenis, asszonyom, felelte Candide." A márkinő gyöngéd mosollyal mondta neki: "Ugy felelsz, mint egy westphaliai ifjuhoz méltó; egy francia igy szólt volna: Igaz, hogy szerettem Kunigunda kisasszonyt, de mióta önt megláttam, ugy érzem, hogy már nem szeretem őt.	Bà hầu tước nở nụ cười dịu dàng: - Nghe ông nói biết ngay ông là một người Đức trẻ tuổi sống ở Westphalie; một người Pháp thì trả lời như sau: "Thật tình, tôi đã yêu cô Cunégonde; nhưng nhìn thấy bà, thì thưa bà, tôi lo sẽ không yêu cô ấy nữa".
- Ó asszonyom, sóhajtott Candide, ezután ugy felelek, amint te óhajtod.	- Vậy thưa bà, tôi sẽ đáp lời như ý bà muốn.
- Iránta való szerelmed azzal kezdődött, hogy felemelted a zsebkendőjét, én azt akarom, hogy emeld fel a harisnyakötőmet.	- Ái tình của ông đối với cô ta bắt đầu từ lúc ông lượm cái mùi soa cho cô ta, phải vậy không?
- A legszivesebben, mondá Candide és felemelte azt.	Tôi muốn bây giờ ông lượm cho tôi cái dây nịt của tôi. - Xin hết lòng thưa bà.
- De azt is aka­rom, hogy kösd azt a harisnyámra," kacérkodott az asszony.	Rồi chàng lượm dây nịt lên. - Tôi muốn ông nịt lại cho tôi!
És Candide rákötötte.	Bà hầu tước nói.
A bájos nő, ki két hatalmas gyémántgyürüt vett észre az idegen ifju ujjain, olyannyira szivből dicsérte azokat, hogy Candide kezéről csakhamar az övére vándoroltak át.	Người đẹp vừa thấy hai hột kim cương lớn lóng lánh trên hai bàn tay của vị khách quý; bà ngỏ lời khen ngợi, nồng nàn khéo léo, đến nỗi hai chiếc nhẫn kim cương từ tay chàng lọt ngay sang tay bà.
Candide, mikor a perigordi apát társaságában visszatért, bizonyos önvádat érzett, amiért hütlen lett Kunigunda kisasszonyhoz.	Khi ra về với ông tu viện trưởng, chàng cảm thấy một chút hối hận vì đã bất trung tín với cô Cunégonde.
Sokat emlegette előtte Kunigundát és Candide fogadkozott, hogy ha Velencében meglátja, hütlenségéért bocsánatot kér a szép leánytól.	Ý định của ông là hưởng thụ càng lâu càng tốt, những lợi lộc mà sự quen biết với chàng Ngây Thơ còn có thể đem lại cho ông.
A perigordi udvariassága és figyelmessége fokozódott és egyre gyöngédebben kezdett érdek­lődni minden iránt, amit Candide tett vagy tenni szándékozott.	Ông tỏ ý kiến về cô Cunégonde rất nhiều, trong khi nói chuyện với chàng; và chàng cho ông hay chàng sẽ xin lỗi cô về vụ bất trung tín, khi nào chàng gặp lại cô ở Venise.
"Találkád van Velencében?	- Vâng, thưa tu viện trưởng.
kérdezte tőle.	Tu viện trưởng hỏi:
- Igen, apát úr, mondá Candide; okvetlenül meg kell találnom Kunigunda kis­asszonyt.	- Tôi chắc là cô gái thông minh ấy có viết cho ông những bức thư diễm tình lắm?
- Úgy gondolom, jegyezte meg az apát, hogy Kunigunda kisasszony igen szellemes és igen bájos leveleket ir.	Ông tu viện trưởng chăm chú nghe, tỏ vẻ mơ màng một chút.
Másnap Candide, mikor felébredt, a következő levelet kapta:	Em sẽ bay vào vòng tay của anh; nếu em cử động được.
A buenos-ayresi kormányzó mindent elrabolt tőlem, csak a te szived maradt meg nekem!	Sự hiện diện của anh sẽ làm cho em hết bệnh hoặc chết vì vui mừng".
Ez a bájos, váratlanul jött levél kimondhatatlan boldogsággal árasztotta el Candide-ot, habár kedves Kunigundájának betegsége fájdalommal gyötörte is lelkét.	Giữa hai nỗi lòng ấy, chàng thu xếp hết số vàng và kim cương của chàng, rồi cùng Martin đến khách sạn mà cô Cunégonde đang ở trọ.
"Óvatosság!	- Coi chừng!
Ha már nem láthatsz, legalább szólj hozzám!	Nếu em không ra khỏi mùng được thì hãy nói với anh!
- Nem tud beszélni, vágott közbe a szolgáló."	Người tớ gái đáp liền: - Cô không nói được!
Ekkor a beteg nő kihuzván kövér kezét az ágyból, Candide-nak nyujtá, ki hosszu ideig könnyei­vel öntözte azt, majd gyémántokkal rakta tele; az arannyal telt zsákja pedig a pamlagon hevert.	Lúc này, người nằm trong mùng đưa ra một bàn tay tròn trịa mà chàng Ngây Thơ tưới xuống những giọt nước mắt; sau chàng để kim cương vào đầy bàn tay nàng.
Lelki háborgásai közepette egyszer csak megérkezik egy rendőr, a perigordi apát és néhány porkoláb kiséretében.	Chàng đem theo một cái túi đầy vàng mà chàng để trên một cái ghế bành.
Azonnal parancsot ad, hogy ragadják meg őket a pribékek és hurcolják tömlöcbe.	Rồi ông ra lệnh các dũng sĩ của ông bắt hai người để bỏ vào đề lao.
"Eldorá­dó­ban nem igy bánnak az utasokkal, jegyezte meg Candide.	- Tại Eldorado, người ta không đối xử với du khách ngoại quốc như thế này.
- Most már sokkal határozottabban manicheus vagyok, mint eddig, mondá Martin.	Ông Martin tiếp lời: - Tôi lại càng tin thêm thuyết thiện ác cộng đồng của tôi.
- Hová vitetsz bennünket? kérdé Candide.	- Ngài đem chúng tôi đi đâu đây?
- Egy földalatti tömlöcbe, nyugtatta meg a rendőr."	- Đi tới một hầm tối của đề lao.
Martin összeszedve hidegvérét, rögtön belátta, hogy az a hölgy, aki Kunigundának adta ki ma­gát, közönséges szélhámosnő s a perigordi apát viszont egy szélhámos, aki visszaélt Candide hiszékenységével s a rendőr egy harmadik szélhámos, akitől könnyü volna megsza­ba­dulni.	Martin khi bình tâm trở lại, suy đoán ra rằng cái bà tự nhận là cô Cunégonđe ấy là một tên nữ tướng lường gạt; cái ông tự xưng là tu viện trưởng ấy cũng là một tay lường gạt; còn tên sĩ quan cũng là một tên lường gạt nữa.
- És miért fogják el az idegeneket?	- Nhưng tại sao người ta bắt tất cả những người ngoại quốc?
Ekkor a perigordi apát szólalt meg: "Azért, mert egy atrébatiai semmirekellő valami bolond­ságot hallott beszélni; ennek hatása alatt király-gyilkosságot követett el, nem olyant, mint 1610 májusában történt, hanem olyant, mely 1594 december havában, olyasfélét, amilyeneket más években s más hónapokban gyakran követtek el más semmirekellők, kik valami bolond­ságot hallottak mesélni."	- Đó bởi vì một tên khố rách áo ôm xứ Artois đã nghe nói những điều xằng bậy: việc đó khiến hắn phạm tội giết vua, không chỉ vụ xảy ra hồi tháng Năm năm 1694, mà còn cả vụ tháng Mười hai năm 1594, và còn nhiều tên vô lại khác nghe những lời xằng bậy mà phạm tội ấy vào những năm khác tháng khác.
A rendőrtiszt ekkor megmagyarázta, miről van szó.	Thế là viên cảnh vệ giải thích rõ thêm.
Bár mielőbb kiszabadulhatnék ebből az országból, hol majmok bosszantják a tigriseket.	Liệu tôi có thể ra khỏi xứ này cấp tốc, một xứ mà khi dám chọc giận hùm beo!
- Csak Alsó-Normandiába vezethet­lek," mondá a rendőrtiszt.	- Tôi chỉ có thể đưa ông đến miền nam Normandie.
Éppen egy kis hollandi hajó horgonyozott a kikötőben.	Lúc này có một chiếc tàu Hà Lan nhỏ ở ngoài khơi.
A normandiai, ki másik három darab gyémánt segitségével fölöttébb szolgálatrakész emberré vált, feltette Candide-ot és embereit az angolországi Portsmouth-ba induló hajóra.	Nhờ ba viên kim cương nữa làm quà, mà người em của viên sĩ quan đã trở thành người tận tâm nhất trên đời; hắn đưa chàng Ngây Thơ và những người đi theo chàng xuống tàu.
Igaz, hogy ez az ut nem Velencébe vitt, de Candide ugy érezte, hogy a pokol kinjából szabadul meg, és arra számitott, hogy az első kinálkozó alkalommal Velencébe hajózik.	Đó không phải là đường đi Venise, nhưng chàng Ngây Thơ cũng vui lòng vì thoát được cái hỏa ngục, chàng sẽ tính chuyện đi Venise sau, khi có cơ hội.
HUSZONHARMADIK FEJEZET.	Chương XXIII
Candide és Martin angol partokhoz érkeznek; mit látnak ott?	CHÀNG NGÂY THƠ VÀ MARTIN TỚI MIỀN DUYÊN HẢI ANH RỒI BỎ ĐI NGAY
"Ó, Pangloss, drága Panglossom!	Trên chiếc tàu Hà Lan, chàng Ngây Thơ la lên:
Ó, Martin, Martin!	- Pangloss tiên sinh ơi!
- Ismered Angliát?	- Là một cái vừa điên rồ vừa ghê gớm!
Ott is olyan bolondok az emberek, mint Franciaországban?	- Cũng là một sự điên rồ nhưng là điên rồ theo một lối khác.
- Ez valami másfajta bolondság, mondá Martin; tudod, hogy e két nemzet örökös harcban van egymással Canada nehány holdnyi hóboritotta földjéért s e háborura több pénzt elfecsérelnek, mint amennyit egész Canada ér.	Hẳn ông biết rằng hai nước ấy gây chiến với nhau chỉ vì vài thửa đất tuyết phủ gần xứ Gia Nã Đại, họ chi phí vào cuộc chiến tốt đẹp này một số tiền đáng giá hơn cả giá xứ Gia Nã Đại.
"Mi történik itt?	Chàng Ngây Thơ hỏi:
"Egy tábornok, mondották.	Người vừa bị giết với đủ nghi thức là ai?
- S miért ölnek meg egy tábornokot?	- Người ấy là một đô đốc.
- Mert nem öletett meg elég embert; háboruskodott egy francia generálissal és azt találták, hogy nem közelitette meg eléggé.	- Và tại sao lại giết người đô đốc ấy? - Vì ông ta không chịu giết cho thật nhiều người.
- De hiszen, jegyezte meg Candide, a francia generális ép oly közel volt az angol generálishoz, mint az utóbbi az előbbihez.	- Nhưng tôi thấy vị đô đốc Pháp cách xa vị đô đốc Anh một khoảng cũng như ông này cách xa ông kia.
Candide ugy elkábult és megrendült attól, amit látott és hallott, hogy nem is akarta lábát a partra tenni és egyezséget kötött a holland hajóskapitánnyal, még ha meg is rabolja, mint a surinami, hogy vigye vissza Velencébe.	Chàng Ngây Thơ choáng váng và thấy chướng tai gai mắt về những điều trông thấy và nghe thấy, đến nỗi chàng thương lượng với ông chủ tàu Hà Lan đưa chàng đi Venise ngay lập tức dầu chàng có bị lường gạt, cướp của như ở Surinam.
A kapitány hajlandó volt ezt két nap mulva megtenni.	Viên thuyền trưởng sẵn sàng sau hai ngày.
"Dicsértessék az ur neve!	- Đội ơn Chúa!
mondá Candide Martint átölelve; itt fogom meglátni a szép Kunigundát.	Tại đây tôi sẽ gặp lại cô Cunégonde xinh đẹp của tôi.
Minden nagyon jól van, pompásan folynak a dolgok, a lehető legjobban folynak a dolgok."	Mọi việc đều tốt đẹp, mọi sự đều hoàn hảo, mọi sự sẽ hoàn thiện hơn mãi.
HUSZONNEGYEDIK FEJEZET.	Chương XIV
Raquette és Giroflée barát története.	GẶP LẠI CÔ PAQUETTE TRONG TAY MỘT TU SĨ
Kunigunda biztosan meghalt; most már nekem sincs más hátra, mint elpusztulnom.	Có lẽ Cunégonde đã chết rồi, thôi tôi chỉ còn có chết theo cô cho rồi.
Igazad van, kedves Martinom, hogy minden csak illuzió és nyomoruság."	Ông bạn Martin ơi, ông nói có lý biết bao: Mọi sự đều là ảo ảnh, đều là tai họa!
Martin igy szólt hozzá:	Martin bảo chàng:
Martin szavai nem nagyon bátoritók voltak.	Những lời của Martin không khuyên nổi chàng Ngây Thơ.
Candide búskomorsága egyre növekedett, Martin pedig fáradhatlanul bizonyitgatta neki, hogy nincs a földön erény és boldogság, kivéve talán Eldorádót, de oda viszont senki sem tud eljutni.	Chàng càng đau buồn thêm. Ông Martin không ngớt lời giải thích cho chàng thấy trên thế gian này có rất ít đạo đức và hạnh phúc, ngoại trừ ở xứ Eldorado là nơi không ai đi tới được.
"De azt már csak elismered, mondá Candide Martinnak, hogy ezek boldog emberek.	- Ít ra ông cũng phải nhìn nhận rằng cặp này sung sướng.
Igaz, hogy e pillanatig, Eldorádót kivéve, az egész emberlakta földön csak szerencsétlen embereket találtam, de fogadni mernék, hogy ez a lány meg ez a szerzetes boldog teremtmények.	Từ trước đến giờ tôi gặp ở nơi nào có người ở, thì nơi đó có những kẻ khổ sở, ngoại trừ xứ Eldorado; bây giờ tôi dám cá rằng thiếu nữ và tu sĩ kia là người rất sung sướng.
- És fogadni mernék, hogy nem azok, mondta Martin.	Martin cãi lại: - Tôi cá rằng họ không sung sướng.
- Meghivjuk őket ebédre és meglátod, hogy nem csalatkozom, szólt Candide."	Chúng ta chỉ mời họ đi ăn là ông sẽ thấy tôi đoán không lầm.
E szavakra Candide, ki eddig nem méltatta figyelemre a leányt, mert folyton Kunigunda járt az eszében, igy kiáltott fel:	Từ nãy đến giờ chàng Ngây Thơ đâu có để ý nhìn cô vì đầu óc còn bận mơ tưởng đến Cunégonde.
Ha egy hires orvos nem vett volna gondjaiba, nem kerülhettem volna el a halált.	Ít lâu sau vì thọ ơn y sĩ ấy, tôi phải làm người tình của ông ta.
Ártatlan­ságom nem mentett volna meg, ha nem találtak volna szépnek.	Nếu tôi không có chút nhan sắc thì tôi đã không thể thoát tội.
Ó uram, ha el tudnád képzelni, mit jelent az, mikor kénytelenek vagyunk egyformán becézni egy vén kufárt, egy ügyvédet, egy barátot, egy sajkást vagy egy apátot; kitéve lenni mindenfajta bántalomnak és gyalázatnak, gyakran jutni abba a kényszerhelyzetbe, hogy egy szoknyát kérjünk kölcsön, melyet az első jött-ment gazember leszaggat rólunk, hogy az egyik elrabolja azt, amit a másiktól nyertünk, folyton utjában lenni az igazságszolgáltatás embereinek és az egyetlen kilátás, mi előttünk van: rettentő öregség, kórház vagy szemétdomb - elgondolhatod, hogy én vagyok a világ leg­boldogtalanabb teremtménye."	Có bao giờ ông có thể tưởng tượng được cái nghề này ra sao: phải mơn trớn một ông già lái buôn, một luật sư, một thầy tu, một anh lái đò, một tu viện trưởng, ai cũng như ai; lại còn phải chịu những lời chửi rủa, những sỉ nhục; có khi phải đi mượn một cái váy của chị em mà bận để rồi cho một thằng cha kinh tởm tốc lên; lại có khi bị một khách làng chơi móc hết số tiền vừa kiếm được với một khách khác; có khi bị cảnh sát bắt giữ làm tiền, trong khi ấy, chỉ thấy viễn cảnh của tuổi già khủng khiếp, hay một nhà thương và một đống rác.
- Ó, uram, felelte Paquette, ez is egyike a mi mesterségünkkel járó nyomoruságoknak.	Chàng Ngây Thơ nghe xong câu chuyện của Paquette, hỏi lại cô:
Tegnap meglopott és elvert egy katonatiszt s ma már jókedvünek kell látszanom, hogy megnyerjem a tetszését ennek a barátnak."	- Nhưng cô tỏ ra vẻ vui cười, hài lòng, khi tôi gặp cô hồi nãy; cô ca hát, cô bẹo má vị tu sĩ, tỏ ra mình là người sung sướng, chứ đâu có khổ sở như cô nói.
Féltékenység, egyenetlenség, őrület uralkodnak a kolostorban.	Chắc cha rất hài lòng với nghề làm tu sĩ Théatin của mình.
"Jót állok érte, hogy ezzel a pénzzel boldogok lesznek.	Martin xoay lại phía chàng Ngây Thơ hỏi:
- Én egyáltalában nem vagyok e nézeten, mondá Martin, ezzel a pénzzel talán még szerencsétlenebbekké teszed őket.	Chàng Ngây Thơ tặng Paquette hai ngàn bạc và ông Giroffée một ngàn đồng, rồi nói với Martin: - Tôi xin trả lời ông rằng với số tiền ấy họ sẽ sung sướng.
- Lesz, ami lesz, mondá Candide, de egy dolog mégis vigasztalásomra szolgál; látom, hogy sokszor találkozik az ember olyan személyekkel, akikkel már sohasem remélt találkozni; ha feltaláltam a vörös kost és Paquette-et, lehetséges, hogy még Kunigundát is feltalálom.	- Tôi không tin; có lẽ ông sẽ làm cho họ khổ hơn với số tiền ấy. - Việc ra sao thì sẽ biết, chỉ có một điều làm cho tôi được an ủi là có những người mình tính không bao giờ gặp được mà lại được gặp.
- Kivánom, hogy légy boldog vele, de erősen kételkedem benne.	- Tôi ao ước được như vậy và có ngày cô sẽ tạo hạnh phúc cho ông, song tôi vẫn cứ nghi ngờ.
- Nagyon durva vagy, mondá Candide.	- Ông cứng rắn quá.
- Mert vannak már tapasztalataim, felelé Martin.	- Ấy là vì tôi đã từng trải nhiều rồi.
- De nézz csak e gondolásokra, szólt Candide; nem énekelnek-e szünet nélkül?	- Ông hãy nhìn những người chèo du thuyền kia: họ chẳng luôn luôn ca hát đó sao?
Igaz, hogy mindent össze vetve, egy gondolásnak a sorsa különb mint egy dogenak; de ugy hiszem: annyira jelentéktelen a különbség, hogy összehasonlitásra sem érdemes.	Cố nhiên nếu xét tổng quát thì số phận của anh chèo thuyền khá hơn số phận của vị nguyên thủ, nhưng theo tôi sự sai biệt không có là bao và không đáng cứu xét.
- Sokat beszélnek, mondá Candide, Pococuranté szenátorról, ki a Brenta mellett abban a szép palotában lakik s akinek házában sok idegen fordul meg; azt erősitgetik, hogy ennek az embernek még sohasem volt bánata.	Chàng Ngây Thơ lại hỏi: - Người ta nói rằng có ông nguyên lão nghị viên Pococurenté sống trong cái lâu đài tốt đẹp kia bên sông Brenta; ông ta tiếp đón người ngoại quốc ân cần lắm.
- Szeretném látni ezt a ritka példányt," mondá Martin.	- Nếu vậy tôi cũng muốn đi thăm một người hiếm có như thế.
Candide tüstént kérette Pococuranté őnagyméltóságát: engedje meg, hogy másnap tiszteletüket tegyék nála.	Chàng Ngây Thơ liền bảo bạn xin phép Pococuranté để được đến thăm ông ngày mai.
HUSZONÖTÖDIK FEJEZET.	Chương XXV
Látogatás Pococuranté őnagyméltóságánál, a velencei nemesnél.	ĐI DU THUYỀN ĐẾN THĂM LÃNH CHÚA POCOCURENTÉ, NHÀ QUÝ TỘC THÀNH VENISE
Candide és Martin gondolára szálltak a Brentán és igy értek a nemes Pococuranté palotájához.	Chàng Ngây Thơ cùng ông Martin đi thuyền "gông đôn" trên sông Brenta đến cung điện của nhà quý tộc Pococurenté.
Először két csinos és szépen öltözött lány szolgált fel csokoládét tejszinhabbal.	Trước hết hai thiếu nữ đẹp, quần áo sạch sẽ, đem kem sôcôla ra mời khách, thứ kem làm rất khéo.
Candide nem állta meg, hogy meg ne dicsérje szépségöket, bájos modorukat és ügyességöket.	Chàng Ngây Thơ tấm tắc khen nhan sắc hai cô, sự duyên dáng và khéo léo của hai cô.
Candide-ot, amint reggeli után egy nagy képtárban sétált, nagyon meglepte a képek szépsége: megkérdezte, ki festette az első kettőt.	Sau bữa ăn trưa, chàng Ngây Thơ đi tản bộ trong hành lang trưng bày những bức họa; chàng phải ngạc nhiên ngắm nghía, hỏi hai bức đầu là của danh sư hội họa nào?
Sok képem van, de már rájok se nézek."	Tôi có nhiều bức họa, nhưng tôi không buồn nhìn đến nữa.
Ebéd előtt Pococuranté hangversenyt rendeztetett.	Chàng Ngây Thơ thấy điệu nhạc êm dịu.
Candide pompásnak találta a zenét.	Ông nghị lên tiếng phê bình:
"Ez a lárma, mondá Pococuranté, mulattat egy félóra hosszat; de ha tovább tart, mindenkit elfáraszt, bár senki sem meri azt bevallani.	- Tiếng huyên náo này chỉ có thể mua vui trong nửa giờ; nếu kéo dài hơn nữa, nó làm mọi người mệt nhọc, dầu không ai dám nói ra.
A zene ma nem egyéb, mint a nehézségek elháritásának müvészete és az, ami csupán nehéz, nem tetszhetik sokáig.	Ngày nay âm nhạc chỉ là một nghệ thuật trình bày những cái khó khăn, mà cái gì có tính cách khó khăn thì không làm cho người ta vui thích lâu dài được.
Sokkal jobban szeretném a dalmüvet, ha nem találták volna fel a titkát annak, hogy ebből is vérlázitó szörnyüségeket alakitsanak.	Có lẽ tôi ưa nhạc kịch hơn, nếu người ta không làm cho vở nhạc kịch thành quái gở khiến tôi bất bình.
Asztalhoz ültek; a pompás ebéd után könyvházba léptek.	Chủ và khách ngồi vào bàn ăn.
Candide megpillantván egy pompá­san bekötött Homerost, dicsérte ő nagy méltóságát kiváló izléséért.	Sau bữa ăn, họ đưa nhau vào phòng đọc sách, chàng Ngây Thơ thấy một cuốn sách của Homère, đóng rất đẹp, ngỏ lời khen ngợi theo sở thích của chàng:
"Lám, ez a könyv volt a nagy Panglossnak, Németország legkiválóbb filozófusának legna­gyobb gyönyörüsége.	- Thật là cuốn sách gây thích thú cho Pangloss, triết gia danh tiếng nhất nước Đức.
- De Vergiliusról máskép gondolkozik Nagyméltósá­god?	Tất cả bao nhiêu sự kiện ấy làm cho tôi buồn đến chết được.
kérdé Candide.	Chàng Ngây Thơ hỏi:
Többre becsülöm nála Tassot és Ariosto dajkameséit.	- Thưa ngài, tôi mạn phép hỏi ngài có thích đọc Horace không?
- Szabad megkérdeznem Nagyméltóságodat - kérdé Candide, hogy nagy gyönyörüsége telik-e Horatius olvasásában?	- Trong ấy có những châm ngôn mà con người lịch sự trên đời dễ sử dụng.
Undorral tudtam csak olvasni durva verseit az öregasszonyok és boszorkányok ellen; s nem tudom felfogni, mily érdem azt mondani Mecaenas barátjának, hogy a csillagokig ér dicsőségtől övezett feje, ha barátja a lirai költők közé számitja őt.	Tôi rất ghê tởm phải đọc những câu thơ thô tục của ông chống lại các bà già và các mụ phù thuỷ; và tôi cũng chẳng hiểu thơ ông ta giá trị ở chỗ nào khi ông ta nói với ông bạn Maecenas của mình rằng nếu ông ta được xếp vào hàng các thi sĩ trữ tình thì vầng trán cao cả của ông ta sẽ va vào các vì tinh tú.
Az ostobák mindent megbámulnak egy hires költőben; én csak a magam kedvéért olvasok, én csak azt szeretem, mely az én izlésemnek felel meg."	Kẻ khờ dại luôn luôn mến chuộng một tác giả đã được ưa thích, còn tôi thì tôi đọc sách là để cho tôi; tôi đọc cái gì tôi áp dụng được.
- Sohasem olvastam, mondá a velencei, mit érdekel engem, hogyan védte Rabiriust, vagy Cluentiust.	- Dầu tác giả ấy có bào chữa cho Rabirius hay Cluentius cũng chẳng quan hệ gì.
- Mennyi olasz, spanyol és francia szindarabot látok itt, jegyezte meg Candide.	- Phải, vị nghị sĩ đáp, có đến ba ngàn vở mà tôi không thấy được ba tá kịch có giá trị.
- Igen, mondá a szenátor, de alig van három tucat jó; ami a beszédgyüjteményeket illeti, mindezek együttvéve nem érnek fel Seneca egyetlen lapjával s ami ezeket a vaskos theologiai müveket illeti, higyjétek el, hogy sohasem nyitom fel őket, sem én, sem senki."	Còn những cuốn thuyết giáo kia, tất cả không đáng giá bằng một chương của Sénèque; những cuốn sách thần học đồ sộ kia, tôi không bao giờ mở ra một cuốn, và cũng không có ai đọc.
Martin észrevette, hogy az egyik polc angol könyvekkel van tele.	Martin nhìn thấy những ngăn chứa đầy sách viết bằng tiếng Anh, liền nói:
- Igen, válaszolta Pococuranté, nagyon szép dolog megirni, amit az ember gondol, ez az ember privilégiuma.	Ông Pococurenté đáp: - Phải, được tự do viết điều gì mình suy nghĩ thì tốt đẹp làm sao!
Nagyon örvendenék annak a szabadságnak, mely az angol lángelmék müveiből kiárad, ha a pártoskodás szelleme nem rontana meg mindent, ami becses e szabadságban."	Tôi rất bằng lòng về sự tự do mà các nhà hiền triết Anh phát biểu, nếu tinh thần bè đảng đừng làm hư lại cái tinh hoa đáng trọng của tự do cao quý ấy.
"Ugyan!	- Ông ấy à?
Én becsüljem valamire azt az irót, ki tönkre tette a Tasso által megalkotott poklot és ördögöt, ki Lucifert majd varangyos békává, majd törpévé változtatja, ki százszor is elmondat vele egy beszédet, sőt még theologiai vitákba is belekényszeriti, ki tudákosan utánozva Ariosto komi­kus találmányát a lőfegyverekről, az égben az ördögökkel ágyut süttet el!	Tôi đâu phải người ưa thích tác giả; ông ta làm hư hỏng cả ý niệm về địa ngục và ma quỷ của Tasse, mô tả quỷ Lucifer khi là loài cóc, khi là giống người lùn; ông lặp lại cả trăm lần những lời giống nhau, thảo luận về thần học; trong khi tỏ ý bắt chước Arioste khi ông này mô tả ra sự sáng tạo ra hỏa khí để khôi hài, ông ta lại tả một cách trịnh trọng cảnh ma quỷ bắn súng thần công lên trời.
Sem én, sem senki Olaszországban nem tudott gyönyörüséget találni ezekben a szomorkás különlegességekben.	Tôi cũng như mọi người khác ở Ý, không ai tin được những chuyện kỳ dị buồn thảm ấy.
A Bünnek és Halálnak házassága; a viperák, melyeknek a Bün életet ad, minden jobb izlésü ember szemében utálatosak; s egy kórháznak hosszadalmas leirásában legfeljebb a sirásók lelik gyönyörüségöket.	Hôn phối giữa Tội lỗi và Tử thần với những con rắn mà Tội lỗi sinh sản, làm cho người nào có ý thức đều phải nôn mửa; việc mô tả rất dài về một nhà thương chỉ hay đối với những kẻ đào huyệt.
Egyéb­ként én azt mondom, amit gondolok és nagyon keveset adok rá, hogy mások hogyan gondolkoznak."	Rốt cuộc, tôi nói những điều gì tôi suy nghĩ, chứ tôi không cần muốn người khác cũng phải suy nghĩ như tôi.
Candide-ot elszomoritotta ez a beszéd; ő ugyanis sokra becsülte Homerost és Miltont is kedvelte.	Chàng Ngây Thơ buồn rầu vì những lời nói ấy; chàng tôn trọng Homère, chàng ưa thích Milton.
"Istenem!	- Than ôi!
sóhajtotta Candide Martin felé fordulva, attól tartok, hogy ez a férfiu még a mi német költőink iránt is fenséges megvetéssel viseltetik.	Tôi rất lo sợ rằng ông này sẽ khinh bỉ thậm tệ những thi sĩ của nước Đức chúng ta.
- Nem lenne oly nagy baj, sugta vissza Martin.	- Có thế cũng chẳng hại gì lớn. Martin đáp.
- Ó, mily felsőrendü ember!	Chàng Ngây Thơ lẩm bẩm: "Ồ!
mormogta Candide a fogai közt, mily kiváló szellemü ember ez a Pococuranté, semmi sem tudja tetszését megnyerni."	Cái ông này tự cao tự đại biết bao; ông ta cho mình là một danh nhân cao cả, không có tác giả nào làm cho ông hài lòng."
Régen megmondta Platon, hogy nem azok a jó gyomrok, melyek minden tápláléktól irtóznak.	Đã lâu lắm Platon nói rằng "những bao tử tốt hơn hết không phải là những bao tử hắt hủi tất cả những món ăn".
- De nem nagy gyönyörüség-e, mondá Candide, mindent fölényesen megbirálni s abban is megérezni a hibákat, amiben mások csak szépségeket látnak?	Chàng Ngây Thơ nói tiếp: - Nhưng người ta cũng thấy vui thích khi có thể chê bai tất cả và nhận thấy những lỗi lầm ở những cái mà kẻ khác cho là tốt đẹp, ông có đồng ý không?
- Szóval nagy gyönyörüség, folytatta Martin, hogy semmiben sem tudunk gyönyörködni.	- Ông nói vậy có nghĩa là người ta thấy vui thú trong lòng chỉ vì chê bai và nói mình không thấy gì vui thú?
- Akkor tehát egyedül én vagyok boldog, mondá Candide, feltéve, hogy viszontlátom Kunigundát.	- Vậy thì chỉ có tôi là sung sướng khi tôi gặp lại được cô Cunégonde.
- Mindég jó, mig reménykedni tud az ember, felelte Martin."	- Ông nên hy vọng là phải lắm. Martin kết luận.
Napok, hetek multak el és Cacambo még mindég nem jött vissza; Candide annyira elmerült fájdalmában, hogy eszébe sem jutott, hogy Paquette és Giroflée elfeledtek neki jóságáért köszönetet mondani.	Thế rồi ngày tháng trôi qua; Cacambo vẫn không thấy trở lại. Chàng Ngây Thơ đau buồn quá, đến nỗi chàng không còn quan tâm đến việc cô Paquette và tu sĩ Giroflée không trở lại để cảm ơn chàng.
HUSZONHATODIK FEJEZET.	Chương XXVI
Candide és Martin együtt vacsorálnak	- Xin ông sẵn sàng đi với tôi; ông cần đi gấp.
hat idegennel; kik ezek az idegenek?	Chàng ngoảnh lại thì thấy Cacambo.
Hol találhatom?	Cô ta ở đâu?
Vezess hozzá, hogy meghaljak az örömtől vele együtt.	Anh hãy đưa tôi đến với cô để tôi cùng với cô chết vì vui sướng.
- Kunigunda nincs itt, mondá Cacambo, Konstantinápolyban van.	- Cunégonde không có ở đây. Cô ở tận Constantinople.
- Nagy ég!	- Ở tận Constantinople à!
Konstantinápolyban.	Cacambo đáp:
De ha mindjárt Chinában lenne is, utána repülök... Utazzunk.	Ông chớ hở môi nói một câu gì và phải sẵn sàng chờ tôi để cùng đi.
Cacambo, ki bort öntött az egyik idegen poharába, vacsora után gazdája füléhez hajolt és ezt sugta neki: "Felség!	Cacambo rót rượu cho một người trong sáu ngoại nhân ấy; rồi đến khi ăn xong anh nói nhỏ với ông ta: Tâu Hoàng thượng, tàu đã sẵn sàng.
a hajó készen áll, akkor indulhat, amikor óhajt."	Hoàng thượng sẽ đi khi nào ngài muốn".
E szavak után eltávozott.	Nói xong anh ta đi ra ngoài.
A vendégek csodálkozva néztek egymásra anélkül, hogy egy szó is elkerülte volna figyelmöket.	Những thực khách ngạc nhiên nhìn nhau không nói một tiếng.
Egyszerre egy másik szolga is közeledik s urához hajolva ezt sugja neki:	Kế đến một tên đầy tớ khác bước lại gần chủ mà nói:
"Felséged hintaja Páduában van s a hajó is készen áll."	- Tâu Bệ hạ, xe của Bệ hạ ở tại Padoue, còn thuyền rồng đã sẵn sàng.
A gazdája intett s a szolga eltávozott.	Ông chủ ra dấu cho tên nô bộc đi ra.
Megint egymásra tekintettek a vendégek s az általános meglepetés fokozódott.	Tên đầy tớ thứ ba tiến lại gần thực khách ngoại quốc thứ ba và nói:
Egy harmadik lakáj egy harmadik idegenhez közeledve ezt sugta neki: "Felségednek nem kell tovább itt maradnia, bizzék bennem én mindent elintézek."	- Thưa Quốc vương, Quốc vương không thể ở đây lâu hơn nữa, kẻ hạ thần đã chuẩn bị đầy đủ.
Aztán hirtelen távozott.	Rồi anh ta bỏ đi ngay.
Candide és Martin biztosra vették, hogy ez egy farsangi álarcos komédia volt.	Chàng Ngây Thơ và Martin tưởng là một trò vui đùa trong ngày hội hoá trang.
miért vagytok ti valamennyien királyok?	Tại sao tất cả các Ngài đều làm vua?
Ami minket illet, bevallom hogy sem én, sem Martin nem vagyunk királyok."	Riêng có tôi và Martin là không làm vua nước nào hết.
Cacambo gazdája vette át a szót és olasz nyelven igy kezdett beszélni: "Egyáltalán nem tréfálok, az én nevem III.	Chủ nhân của Cacambo trịnh trọng cất tiếng và nói bằng tiếng Ý: - Tôi không đùa đâu.
HUSZONHETEDIK FEJEZET.	- Thưa các ngài, không.
Candide Konstantinápolyba utazik.	Tôi không hề ham muốn làm vua.
A hüséges Cacambo megkérte török gazdáját, ki Achmet szultánt készült Konstantinápolyba szállitani, hogy Candide-ot és Martint is vegye fel a hajóra.	Nhân có viên thuyền trưởng đến đón phế đế Thổ Nhĩ Kỳ Achmet về Constantinople, tên nô bộc trung thành Cacambo xin được cho chàng Ngây Thơ và ông Martin cùng đi một chuyến tàu.
Miután szegény ő felsége előtt térdre borultak, mindketten hajóra szálltak.	Cả hai người xuống tàu làm lễ bái yết vị hoàng đế khốn cùng ấy.
Candide utközben igy szólt Martinhoz:	Trên con tàu về nước Thổ, chàng Ngây Thơ nói với Martin:
"Milyen különös, hogy hat, trónjától megfosztott királlyal együtt vacsoráltunk és még a hat közt is akadt egy olyan, akinek én adtam ajándékot.	- Thế là có đến sáu ông vua bị truất phế đã dùng bữa với chúng ta, trong số đó có một vị được tôi giúp đỡ tiền bạc.
Talán még sok más, szerencsétlenebb fejedelem is van.	Có lẽ còn có những vị khác nữa vô phước hơn.
- Bár ugy lenne, mondá Martin.	- Tôi chúc ông được như vậy.
- Hát nem hihetetlen kaland ez, amelyben Velencében volt részünk, ki látott vagy hallott még olyat, hogy hat, trónjától megfosztott király együtt vacsorázzék egy fogadóban.	- Nhưng này ông bạn, có phải là chúng ta đến Venise để trải qua một cuộc phiêu lưu khó tưởng tượng được không. Trên đời có bao giờ ta thấy, hay nghe nói đến sáu phế đế ngồi chung bàn dùng bữa với nhau.
- Ez sem rendkivülibb, mint egyéb dolog, melyben részünk volt, mondá Martin.	- Điều ấy cũng chưa kỳ lạ bằng các biến cố đã xảy ra cho chúng ta, Martin đáp.
Alighogy a hajóra lépett Candide, nyakába borult régi szolgájának és kedves barátjának Cacambonak.	Chàng Ngây Thơ lại chạy đi kiếm Cacambo ở trên tàu, ôm lấy người tớ cũ, vừa là bạn quý của chàng, rồi hỏi:
még mindég szeret?	Nàng có khỏe mạnh không?
hogyan érzi magát?	Nàng vẫn luôn luôn yêu tôi chứ?
Ugy-e vettél neki egy palotát Konstantinápolyban?	Có lẽ anh đã tậu cho nàng một tòa lâu đài ở Constantinople?
- Kedves gazdám, válaszolt Cacambo, Kunigunda az edényeket mossa a Propontis partján egy fejedelemnél, akinek nagyon kevés edénye van, rabszolganő lett egy Rákóczi nevü volt fejedelem házában, akinek a török szultán naponta három aranyat ad menedékhelyén; de ami a legszomorubb dolog: szépségét elvesztette, iszonyuan megcsunyult.	- Thưa ông chủ yêu quý, Cacambo đáp, cô Cunégonde hiện nay đang rửa chén đĩa cho một hoàng thân có rất ít bát đĩa trên bờ biển Propontide; cô là nô lệ trong gia đình một vị quân vương cũ, tên là Ragotski, người được vua Thổ trợ cấp cho ba đồng "ê quy" mỗi ngày để sống.
De hogyan juthatott ily utálatos állapotba, holott te öt-hat milliót hoztál magaddal.	Điều đáng buồn hơn hết là cô Cunégonde không còn đẹp nữa; bây giờ cô xấu ghê gớm!
- Persze!	- Chao ôi!
és egy tengeri rabló nem lopta-e el vakmerően a többit?	Còn bao nhiêu tiền thì bị một tên hải tặc cướp đoạt hết.
S ez a rabló nem vitt-e el bennünket a Matapan fokra, Miloba, Nicariába, Samosba, Petrába, a Dardanellákba, a Marmora partjaira és Scutariba?	Tên cướp còn đưa chúng tôi đến mũi Matapan, đến Milo, đến Nicarie, đến Samos, đến Petra, đến Dardanelles, đến Marmara, đến Scutari.
- Nem tudom elképzelni, jegyezte meg Martin, milyen mérték­kel tudta volna a te Panglossod mérlegelni az emberek szerencsétlenségeit és értékelni fáj­dalmaikat.	- Tôi không biết Pangloss tiên sinh của ông dùng cái cân nào mà cân lường những khổ nhục của các ông hầu xét đoán.
- Lehetséges, mondá Candide."	- Điều ấy có thể có chứ!
Volt a hajón két gályarab; nagyon rosszul eveztek és a hajóskapitány időnként bikacsökkel vágott meztelen vállukra.	Trong số những người tù khổ sai chèo thuyền, có hai người chèo rất dở, thỉnh thoảng lại bị thuyền trưởng cầm roi gân bò, đánh lên hai vai để trần.
Eltorzult arcuk egyes vonásai kis hasonlóságot mutattak Panglossnak és Kunigunda bátyjának, a szerencsétlen jezsuita bárónak vonásaihoz.	Nhìn mặt họ, thấy có vài nét giống với nét mặt của Pangloss và của vị nam tước, tức linh mục dòng Tên, và là anh cô Cunégonde.
"Szavamra mondom, igy szólt Cacambohoz, ha nem láttam volna felakasztva Pangloss mestert s ha szerencsétlenségre nem önkezemmel öltem volna meg a bárót, ugy azt hinném, hogy ők eveznek e gályán."	Chàng nói với Cacambo: - Bạn ơi, nói thật cho anh nghe: nếu tôi đã không thấy tận mắt ông Pangloss bị xử treo cổ, nếu như tôi đã không tự tay đâm chết ông linh mục nam tước, thì chắc là tôi phải đề quyết hai tên chèo thuyền này là hai ông ấy.
A báró és a Pangloss név hallatára a két gályarab hirtelen felkiáltott, felugrott a padról és kiejtette kezéből az evezőket.	Nghe được những tiếng "Pangloss" và "nam tước" mà chàng Ngây Thơ vừa nói ra, hai tù nhân chèo thuyền bỗng thốt ra một tiếng kêu lớn, ngưng tay chèo lại, làm rơi cả hai chiếc bơi chèo.
A hajóskapitány nekik rohant és ugyancsak hulltak rájok a bikacsök-ütések.	Viên thuyền trưởng chạy đến, những roi đòn vun vút trên lưng hai người.
"Hagyd abba!	- Hãy ngưng tay!
Hagyd abba!	Hãy ngưng tay!
kiáltott Candide, annyi pénzt kapsz, amennyit kivánsz.	Muốn bao nhiêu tiền, tôi cũng sẽ trả cho ông!
- Ho­gyan?!	- Té ra chàng Ngây Thơ đấy à?
Ez Candide?!	- Sao?
- kiáltották a gályarabok.	Chính là chàng Ngây Thơ đấy à?
- Álmodom vagy ébren vagyok?	- Phải chăng giấc mộng?
csodálkozott Candide.	Tôi mơ hay tỉnh?
Csakugyan ezen a gályán vagyok?	Tôi đang ở trong thuyền này hay không?
Ez az a báró, akit én megöltem?	Phải chăng ông nam tước mà tôi đã giết?
És ez itt igazán Pangloss, akit függni láttam?	Phải chăng ông Pangloss mà tôi đã thấy xử giảo?
- Mi vagyunk, mi vagyunk, felelték azok.	Cả hai người trả lời: - Chính hai chúng tôi đây!
- Teringettét, kérdé Martin, hát ez az a hires filozófus?	- Sao? Ông chính là nhà đại hiền triết Pangloss đấy à?
- No, hajóskapitány uram, kérdezte Candide, mennyi pénzt akarsz Thunder-ten-tronckh urnak, a birodalom első bárójának és Panglossnak, Németország legalaposabb filozófusának kiváltásáért?	Chàng Ngây Thơ nói gấp với viên thuyền trưởng: - Thưa ông thuyền trưởng, ông đòi bao nhiêu để cho tôi chuộc Nam tước Thunder-ten-tronckh, một trong những nam tước nổi tiếng của đế quốc?
- Megkapod uram, csak hajózzál velünk villámgyorsasággal Konstantinápolyba és ott azonnal kifizetlek, vagy, ami még helyesebb lesz, vezess Kunigunda kisasszonyhoz."	Vì hai tên tù khổ sai tín đồ Cơ đốc này là thứ nam tước lớn và triết gia lớn, nên ta đòi phải chuộc năm chục nghìn đồng "sơ canh".
Candide százszor is átölelte a bárót és Panglosst.	Ông hãy đưa tôi tới nơi trú ngụ của cô Cunégonde.
"De hogy is történhetett az, hogy nem öltelek meg téged, kedves báróm?	Viên thuyền trưởng theo đề nghị của chàng Ngây Thơ, cho thuyền đi thật lẹ tới thành phố, lẹ như cánh chim bay.
És te, drága Pan­glossom, hogyan lehetsz életben, holott felakasztva láttalak és hogyan kerültök mindketten erre a török gályára?	Trên chiến thuyền, chàng Ngây Thơ ôm lấy vị nam tước và ông Pangloss mà hôn nhiều lần; chàng hỏi:
- Igaz, hogy kedves hugom ebben az országban van?	- Làm sao mà nam tước còn sống, tôi đã giết ngài rồi mà?
kérdé a báró.	Vị nam tước hỏi:
- Igenis, felelte Cacambo.	- Thưa, đúng như thế.
- Tehát ismét viszontláthatom az én kedves Candide-omat, ujjongott Pangloss."	Pangloss thì la lên: - Trời ơi, thầy trò chúng mình lại gặp nhau!
Candide bemutatta nekik Martint és Cacambot, mindnyájan megölelték egymást; vala­mennyi­nek megeredt a beszédje és mindnyájan egyszerre beszéltek; repült a hajó, már a kikötőben voltak.	Chàng Ngây Thơ giới thiệu với hai người triết gia Martin và người bạn trung thành Cacambo. Tất cả mọi người ôm lấy nhau, nói với nhau bao nhiêu câu hàn huyên tầm sự.
"De igazán lehetséges, hogy a hugom Törökországban van?	- Có thể chắc là em gái tôi ở Thổ Nhĩ Kỳ không?
tette hozzá.	Cacambo đáp:
Ismét két zsidót keritettek elő, Candide ujra eladott néhány darab gyémántot s mind az öten utrakeltek egy gályán, hogy kiszabaditsák Kunigundát.	Chàng Ngây Thơ cho kiếm hai người Do Thái nữa đến để bán thêm mấy viên kim cương rồi tất cả thuê một chiếc thuyền đi giải thoát cho cô Cunégonde.
HUSZONNYOLCADIK FEJEZET.	Chương XXVIII
Mi történt Candide-dal, Kunigundával,	BIỂN CỐ XẢY RA CHO CHÀNG NGÂY THƠ, CUNÉGONDE, MARTIN, PANGLOSS…
Panglossal, Martinnal és a többivel?	Chàng Ngây Thơ nói với vị nam tước:
- Szóra se érdemes; elismerem, hogy kissé heves voltam, mondá a báró.	Thật ra lúc ấy tôi quá nóng, tôi thú nhận như thế.
Sejtelmem sem volt arról, milyen főbenjáró bűn egy keresztényre nézve, ha meztelenül találják együtt egy fiatal muzulmánnal.	Tôi không biết rằng một người Cơ đốc bị bắt gặp trần truồng với một người Hồi giáo là một trọng tội.
- Hát az hogyan lehetséges, mondá Candide, hogy téged, kedves Panglossom, viszontláthatlak?	- Đúng thật là anh đã thấy tôi bị treo cổ; lúc đầu tôi bị xử thiêu trên giàn hỏa.
nem tudod, hogy az ilyen emberekben mindég az ördög rejtőzködik?	Để tôi chạy đi kêu một linh mục trừ diệt tà ma!
A kadi elé vezettek, aki százat veretett a talpamra és gályára küldött: véletlenségből ugyanazon a gályán, ugyanahoz a padhoz kötöttek engem is, meg a báró urat is.	Tôi chần chừ đứng sựng ở đó khá lâu, đến nỗi vị giáo sĩ già nổi giận, nhận thấy tôi là một tín đồ Cơ đốc, ông kêu cứu.
- Mondd meg kedves Panglossom, kérdé kiváncsian Candide, mikor fel voltál akasztva, mikor keresztvágást kaptál, ütlegekkel halmoztak el, a gályán kellett evezned, mindég azt gondoltad, hogy minden a legjobban van?	- Ông Pangloss thân mến, tôi xin phép hỏi ông: khi ông bị thắt cổ, rồi rạch da bụng, kế đến bị đánh đòn, bị đày đi khổ sai chèo thuyền, thì ông có còn nghĩ là mọi việc sẽ hoàn hảo hơn, hay không?
HUSZONKILENCEDIK FEJEZET.	Chương XXIX
Hogyan talált a meg Candide Kunigundát és az öreg asszonyt?	CHÀNG NGÂY THƠ TÁI NGỘ CUNÉGONDE
Mialatt Candide, a báró, Pangloss, Martin és Cacambo a kalandjaikat mesélték, amig a világ dolgainak összekapcsolódásáról vagy össze nem kapcsolódásáról beszélgettek, mig az okokról és okozatokról vitatkoztak, valamint az erkölcsi és fizikai bajokról, a szabadságról és szükségességről, a vigasztaló érzésekről, melyek eltölthetik az embert, midőn török gályára hurcolják, azalatt a Propontisz partjához értek és az erdélyi fejedelem házához jutottak.	Trong khi chàng Ngây Thơ, vị nam tước, triết gia Pangloss, Martin và Cacambo kể cho nhau nghe những cuộc phiêu lưu của mỗi người, trong khi họ tham luận về những biến cố phối hợp và không phối hợp, về những lẽ nhân quả, về sự khổ vật chất và sự khổ tinh thần, về tự do và tính tất yếu, về những an ủi có thể tìm ra trong lúc làm việc chèo thuyền ở Thổ Nhĩ Kỳ, thì họ đã tới bờ biển Propontide, thấy căn nhà của ông hoàng lưu vong mà cô Cunégonde làm người hầu hạ.
Kunigunda és az öregasszony kerültek legelőször a szemök elé amint a törülközőket a száritó kötélre teregették.	Điều thứ nhất họ trông thấy là cô Cunégonde cùng bà già đang phơi quần áo trên dây kẽm.
A báró elsápadt ennek láttára.	Vị nam tước xám mặt lại trước cảnh tượng ấy.
Candide a gyöngéd szerető, amint szép Kunigundáját megbá­mul­va, fénytelen szemekkel, hervadó kebellel, ráncos arccal, vörös, eldurvult kezekkel meg­pillantotta, megborzadván három lépésnyire visszatántorodott, aztán jobb érzésének engedve mégis előbbre lépett.	Còn chàng Ngây Thơ, người yêu hiền dịu của cô Cunégonde thấy cô màu da đã xạm, giọng nói khô khan, mắt nổi tia máu, má nhăn nheo, cánh tay nắng cháy, tróc da; chàng lui lại ba bước, rùng rợn sau lại bước tới vì xã giao, cô ôm chàng Ngây Thơ và anh của cô; mọi người ôm hôn bà già.
A szomszédságban egy kis majorság volt; az öreg asszony rábirta Candide-ot, hogy vegye meg azt s ott várják be, mig jobb sorsuk lesz.	Bà già khuyên chàng Ngây Thơ nên thích nghi với hoàn cảnh mới, chờ đợi sau này may ra số phận có khá hơn chăng?
Kunigundának sejtelme sem volt róla, mennyire megcsunyult, senki se figyelmeztette rá; Candide-ot oly energikus hangon emlékeztette igé­retére, hogy a jámbor ifju nem merte visszautasitani.	Cô tưởng mình còn nhan sắc, nên nói với một giọng tuyệt đối, nhắc lại với chàng Ngây Thơ những lời hứa cũ; giọng cô quả quyết đến nỗi chàng không dám chối từ.
Közölte a báróval, hogy hugát feleségül szándékozik venni.	Chàng nói cho vị nam tước biết là chàng sẽ cưới em gái ông.
Kunigunda bátyja lába elé vetette magát és megeredtek a könnyei; a báró azonban hajthatatlan maradt.	Cunégonde quỳ xuống ôm chân anh, đầm đìa giọt lệ; ông anh vẫn không lay chuyển.
ha dühömre hallgatnék, még egyszer keresztül döfnélek!	Nàng đang xấu xí mà tôi vẫn chịu cưới làm vợ.
- Ölj meg még egyszer, mondá rendithetetlenül a báró, de amig én élek, nem veszed feleségül a hugomat."	- Anh muốn giết tôi thì cứ giết, nhưng anh không thể cưới em gái tôi khi tôi còn sống.
HARMINCADIK FEJEZET.	Chương XXX
Befejezés.	KẾT LUẬN
Candide, Martin és Pangloss néha-néha metafizikai és erkölcsi kérdésekről vitatkoztak.	Chàng Ngây Thơ cùng Martin và Pangloss đôi khi tranh luận về siêu hình học và luân lý học.
- Nagy kérdés ez," gondolta magában Candide.	- Đó là một vấn đề trọng đại.
Pangloss bevallotta, hogy mindég nagyon szenvedett; mivel azonban eddig azt bizonyitgatta, hogy minden csodálatosan jól van, megmaradt e felfogása mellett, bár már ő maga sem hitte.	Sau cùng, một việc xảy đến minh chứng cho những nguyên tắc đáng ghét của Martin, làm cho chàng Ngây Thơ lại càng do dự hơn bao giờ hết.
Egy bekövetkező esemény megszilárditotta Martint utálatos nézeteiben, megrenditette Candide-ot és még Panglosst is zavarba hozta; egy napon ugyanis Paquette-et és Giroflée barátot látták kikötni majorságuk mellett; a legégbekiáltóbb nyomorban voltak; hamarosan megették háromezer piaszterüket, faképnél hagyták egymást, majd ismét kibékültek, aztán megint összevesztek, tömlöcbe jutottak s onnan megszöktek; Giroflée barát végre törökké lett, Paquette régi mesterségét folytatta, de már nem ment vele semmire.	Đó là việc mọi người trong nhà một hôm thấy cô Paquette và tu sĩ Giroflée bước vào trong nhà, trong một trạng thái khốn khổ cực độ; cặp này cho hay rằng họ đã ăn hết ba ngàn đồng bạc, họ đã bỏ nhau rồi chắp nối lại tơ duyên, gia đình lục đục, kế đến bị bắt vào đề lao sau trốn thoát; tu sĩ Giroflée thì nhập tịch Thổ Nhĩ Kỳ, còn Paquette tiếp tục làm nghề cũ, lăn lóc khắp nơi mà không đủ sống.
- Ó, ó!	- Con ơi!
- mondá Pangloss Paquette­nek, az ég ide vezérelt most benneteket.	Trời đã đưa con đến với chúng ta.
Szegény leánykám, tudod-e, hogy az orrom hegyébe, egyik szemembe és egyik fülembe került a szerelmed?	Con có biết rằng vì con mà ta đã mất một con mắt, một cái tai và cái đầu mũi.
De te is hogy tönkre mentél.	Bây giờ con đến nông nỗi này!
Ó, milyen is ez a világ!"	Thế gian là cái chi chi vậy?
Ez az uj kaland megint okul szolgált rá, hogy többet vitatkozzanak, mint valaha.	Biến cố mới trên đây đã khiến cho mọi người càng nói triết lý nhiều hơn.
Pangloss szólitotta meg őt eképen: "Mester, arra kérünk téged, nyilatkozzál: mi célra teremtődött az a különös állat, melyet embernek nevez­nek?	- Thưa tiên sinh, chúng tôi đến để thỉnh tôn ý. Xin tiên sinh giải thích cho chúng tôi tại sao con vật kỳ dị là cái con người này lại được Tạo hóa sinh ra trên Trái đất?
- Miért avatkozol ilyesmibe?	- Anh đặt ra vấn đề ấy làm gì?
- kérdé a dervis, - a te dolgod ez?	Đâu phải là việc của anh?
- De tisztelendő atyám, tette hozzá Candide, rettentően sok baj van e földön.	- Nhưng, thưa tiên sinh, trên mặt đất đây rẫy những điều xấu xa, đau khổ.
- Mi közöd hozzá, mondá a dervis, hogy jóság vagy gonoszság van-e a földön?	- Xấu hay tốt, có quan hệ gì!
- Tehát mit kell tennünk, kérdé Pangloss.	- Vậy thì phải làm gì trên đời?
- Hallgass! felelé a dervis.	- Anh chỉ có việc lặng thinh.
- Azzal a gondolattal hizelegtem magamnak, mondá Pangloss, hogy eszmecserét folytathatok veled az okokról és okozatokról, a lehető legjobb világról, a gonoszság eredetéről, az emberi lélek természetéről és az előre meg­állapitott összhangról."	- Tôi đến đây là để mong được thảo luận với tiên sinh một chút về cái nhân và cái quả, về thế giới hoàn thiện, về nguyên nhân cái xấu, về tính chất của tâm hồn, và về thuyết điều hòa tiền định.
E szavakra a dervis becsapta orruk előtt az ajtót.	Nghe những câu ấy, vị giáo sĩ đạo Hồi cáo từ Pangloss và đóng sầm cửa lại.
Amig az előbbi társalgás lefolyt, az a hir terjedt el a városban, hogy Konstantinápolyban lefejezték a muftit meg két vezírt s barátaik közül többet karóba huztak: ennek a szerencsétlenségnek a hire néhány óra hosszat nagy port vert fel.	Trong khi hai người trò chuyện, thì có tin loan truyền rằng người ta vừa bóp cổ chết hai vị đại thần cùng một giáo sĩ cao cấp; trước đó người ta đã giết nhiều người trong phe của ba ông, đóng cọc những người ấy, đâm vào ruột gan họ.
"Ugy látom, hogy ez a jámbor aggastyán jobban megkovácsolta a szerencséjét, mint az a hat király, akivel együtt vacsoráltunk.	- Ông già hiền hậu ấy có lẽ sung sướng hơn cả sáu ông vua mà chúng ta được vinh dự ngồi cùng bàn dùng bữa.
Richard, Angol­ország uralkodója, II.	Các vua Joachim, Jéchonias, Sédécias, trở thành nô lệ.
Eduárd, VI.	Các ông có biết…
Henrik, III.	Chàng Ngây Thơ nói:
Henrik császár... Hiszen jól tudod... - De azt is tudom, mondá Candide, hogy művelni kell kertünket.	- Tôi còn biết rằng chúng ta phải trồng tỉa khu vườn của chúng ta. Pangloss nói:
- Igazad van, mondá Pangloss, mert midőn az ember az Éden kertjébe bocsáttatott, azért bocsáttatott be oda, hogy mívelje azt (ut operaretur eum) hogy dolgozzék s ez azt bizonyitja, hogy az ember nem tétlenségre született.	- Anh có lý, bởi vì khi con người được đem ở vào vườn Éden thì anh ta đã bị đem vào đây ut operaretur eum để mà lao động rồi; điều đó chứng tỏ rằng con người không phải được sinh ra để nghỉ ngơi.
- Dolgozzunk minden okoskodás nélkül, mondá Martin, ez az egyetlen mód, mellyel az életet elfogadhatóvá tehetjük."	- Hãy làm việc mà đừng lý sự, Martin nói, đó là phương tiện duy nhất để có được cuộc sống tàm tạm.
Kunigunda ugyan valóban nagyon csunya lett, de kitünő szakácsnő vált belőle; Paquette hímezett, az öregasszony gondozta a fehérnemüeket.	Cunégonde thật sự là rất xấu xí, nhưng cô trở thành một người làm bánh ngọt tuyệt vời; Paquette thì thêu thùa; bà già thì lo việc giặt giũ.
- Igazad van, mondá Candide, de most fogjunk munkához: műveljük kertünket.	- Đúng là như thế, nhưng phải trồng tỉa khu vườn của chúng ta đã.
