Tặng Léon Werth	﻿Léon Werth-nek
Anh xin lỗi các em nhỏ vì đã đem tặng sách này cho một người lớn.	Kérem a gyerekeket, ne haragudjanak, amiért ezt a könyvet egy fölnőttnek ajánlom.
Anh có một lẽ đáng kể: ông người lớn này là người bạn tốt nhất của anh trên đời.	Komoly mentségem van rá: ez a fölnőtt széles e világon a legjobb barátom.
Anh cố thêm một lẽ nữa: ông người lớn này cái gì cũng hiểu được, cả sách viết cho trẻ em.	De van egy másik mentsé­gem is: ez a fölnőtt mindent meg tud érteni, még a gyerekeknek szóló könyveket is.
Anh cố một lẽ thứ ba: ông người lớn này là người nước Pháp, ở đây ông ta đói và rét.	Harmadik mentségem pedig a következő: ez a fölnőtt Franciaországban él, s ott éhezik és fázik.
Ông ta cần được an ủi.	Nagy szüksége van vigasztalásra.
Nếu mà các lẽ ấy vẫn không đủ, anh xin tặng sách này cho em bé là ông người lớn đó trước kia.	Ha pedig ez a sok mentség nem elegendő, akkor annak a gyerek­nek ajánlom könyvemet, aki valaha ez a fölnőtt volt.
Vậy anh chữa lại câu đề tặng của anh:	Ajánlásomat tehát kijavítom, ilyesformán:
Tặng Léon Werth ngày ông còn là cậu bé	Léon Werth-nek, amikor még kisfiú volt.
I	1.
Hồi lên sáu, tôi có nhìn thấy một lần, một bức tranh tuyệt đẹp, trong một cuốn sách về Rừng Hoang nhan đề: "Những câu chuyện có sống qua".	Hatéves koromban egy könyvben, mely az őserdőről szólt, és Igaz Történetek volt a címe, láttam egy nagyszerű képet.
Bức tranh vẽ hình một con trăn đang nuốt một con thú dữ.	Óriáskígyót ábrázolt, amint egy vadállatot nyel el.
Đây là bản sao của bức vẽ.	Tessék, itt a rajz másolata.
Trong sách, người ta nói: "Loài trăn nuốt chửng cả con mồi, không nhai.	A könyvben ez állt: "Az óriáskígyó egészben, rágás nélkül nyeli le zsákmányát.
Sau chúng chẳng nhúc nhích gì được nữa và ngủ sáu tháng liền để tiêu hóa con mồi".	Utána moccan­ni sem bír, és az emésztés hat hónapját végigalussza."
Từ đó, tôi hay nghĩ đến các chuyện xảy ra trong rừng rậm, và đến lượt tôi, với một cây bút chì màu, tôi vẽ được hình vẽ đầu tiên của tôi.	Akkoriban sokat tűnődtem a dzsungelek kalandjain, és egy színes ceruzával nekem is sikerült megrajzolnom első rajzomat.
Nó như thế này:	Ilyesformán:
Tôi đưa cho các người lớn xem kiệt tác của tôi và hỏi họ bức vẽ của tôi có làm cho họ sợ không.	Remekművemet megmutattam a fölnőtteknek, és megkérdeztem őket, nem félnek-e tőle.
Bức tranh của tôi đâu có vẽ một chiếc mũ.	Az én rajzom azonban nem kalapot ábrázolt.
Nó vẽ một con trăn đang tiêu hóa một con voi.	Óriáskígyót ábrázolt, amint épp egy elefántot emészt.
Thế là tôi vẽ lại bên trong bụng trăn, để cho các người lớn có thể hiểu được.	Erre lerajzoltam az óriáskígyót belülről is, hogy a fölnőttek megérthessék, miről van szó.
Đối với người lớn, bao giờ cũng phải giảng.	Mert nekik mindig mindent meg kell magyarázni.
Bức vẽ số hai của tôi thế này:	Ez a 2. számú rajz ilyesforma volt:
Các người lớn khuyên tôi hãy để qua một bên các bức vẽ trăn nhìn bên ngoài hay bổ đôi kia đi, và hãy để tâm vào môn địa, môn sử, môn toán và môn ngữ pháp.	Most aztán a fölnőttek azt ajánlották, ne rajzoljak többé óriáskígyót se nyitva, se csukva, hanem inkább foglalkozzam földrajzzal, történelemmel, számtannal és nyelvtannal.
Như vậy đó mà vào tuổi lên sáu, tôi đã bỏ một cuộc đời họa sĩ tuyệt diệu.	Így mond­tam le hatéves koromban nagyszerű festői pályafutásomról.
Tôi thất vọng vì bức vẽ số một và bức vẽ số hai của tôi không thành công.	Kedvemet szegte 1. és 2. számú rajzom kudarca.
Các người lớn không bao giờ tự mình hiểu được điều gì, và trẻ con lúc nào, lúc nào cũng phải giảng giải cho các ông, đến nhọc!	A nagyok semmit sem értenek meg maguktól, a gyerekek pedig belefáradnak, hogy örökös-örökké magyarázgassanak nekik.
Thế là tôi phải chọn một nghề khác, và tôi học lái máy bay.	Más mesterséget kellett választanom tehát: megtanultam repülőgépet vezetni.
Trên thế giới, đâu tôi cũng từng có bay một tí.	Nagyjából az egész világot berepültem.
Cái đó cần lắm, nếu ban đêm ta bị lạc.	Ez pedig fölöttébb hasznos dolog, ha éjszaka eltéved az ember.
Như vậy đấy, trong cuộc đời tôi, tôi có hàng đống những cuộc gặp gỡ với khối người quan trọng.	Így aztán életem folyamán nagyon sokszor kerültem kapcsolatba komoly emberekkel.
Tôi đã sống nhiều ở nhà những người lớn.	Jócskán akadt dolgom a fölnőttekkel.
Tôi đã nhìn thấy họ rất gần.	Közvetlen közelből láthattam őket.
Việc này vẫn chẳng làm tôi đánh giá họ khá hơn bao nhiêu.	És nem mondhatnám, hogy ettől jobb lett róluk a véleményem.
Thế là tôi chẳng thèm nói với ông ta về rắn trăn, rừng hoang hay trăng sao gì nữa.	Erre aztán nem beszéltem neki se óriáskígyókról, se őserdőkről, se csillagokról.
Tôi tự hạ ngang tầm ông ta.	Alkalmaz­kodtam hozzá.
Tôi nói với ông ta về bài bạc, về đấu bóng, về chính trị và về cà vạt.	Bridzsről beszéltem neki, meg golfról meg politikáról és nyakkendőkről.
Thế là người lớn rất lấy làm bằng lòng được gặp một người biết điều như tôi.	Az illető fölnőtt pedig nagyon örült neki, hogy ilyen okos emberrel került ismeretségbe.
II	2.
Như vậy đó, tôi đã sống một mình, chẳng có ai thật sự chuyện trò, cho đến một hôm tôi hỏng máy bay trong sa mạc Sahara cách đây sáu năm.	Így éltem magányosan, anélkül, hogy igazában bárkivel is szót érthettem volna, míg egyszer, hat esztendővel ezelőtt, kényszerleszállást nem kellett végeznem a Szaharában.
Có cái gì trong máy vỡ.	Valami eltö­rött a motoromban.
Nhưng vì tôi đi một mình, không thợ máy, không hành khách, tôi bắt đầu cố chữa cho được ca hỏng khó khăn này.	És mivel se gépészem nem volt, se utasom, magamnak kellett nekilátnom, hogy zöld ágra vergődjem valahogyan, és kijavítsam a súlyos hibát.
Đối với tôi, đây là một việc sống chết.	Élet és halál kérdése volt ez számomra.
Phải dè lắm tôi mới đủ nước uống tám ngày.	Alig egy hétre való ivóvizem volt.
Buổi tối đầu tiên, thế đấy, tôi ngủ trên mặt cát, mọi vùng có người ở đều cách một nghìn dặm.	Ott dőltem álomra az első este a homokon, ezermérföldnyire minden lakott helytől.
Tôi còn trơ vơ hơn nhiều so với kẻ đắm tàu ở trên bè giữa biển cả.	Elhagya­tottabb voltam, mint tutaján a hajótörött az óceán közepén.
Vậy mà các bạn tưởng tượng, tôi ngạc nhiên biết bao khi, mờ sáng hôm sau, có một giọng nói nhỏ nhẻ, lạ lắm, đánh thức tôi dậy.	Elképzelhető hát, mennyire meg­lepődtem, amikor hajnalban egy fura kis hang ébresztett föl.
Giọng ấy nói:	Azt mondta:
- Ông làm ơn... ông vẽ giúp tôi một con cừu!	- Légy szíves, rajzolj nekem egy bárányt!
- Hả?	- Micsoda?
- Vẽ giúp tôi một con cừu...	- Rajzolj nekem egy bárányt...
Tôi bật lên như bị sét đánh.	Fölugrottam, mintha villám csapott volna le mellettem.
Tôi thấy một cậu bé hết sức dị thường đang nghiêm trang nhìn tôi.	És egy apró emberkét láttam, egy teljességgel rendkívüli kis emberkét, amint komoly figyelemmel szemlél.
Đây, bức chân dung đẹp nhất mà về sau tôi vẽ được về cậu bé ấy:	Itt a legjobb kép, amit később csinálnom sikerült róla.
Nhưng bức vẽ của tôi hẳn là còn kém đẹp hơn người mẫu rất nhiều.	Csakhogy az én rajzom kétségkívül sokkal kevésbé elragadó, mint amilyen a mintája volt.
Lỗi đâu phải tại tôi.	Igaz, nem az én hibámból.
Tại người lớn mà tôi nản lòng trong sự nghiệp hội họa, vào lúc lên sáu, và tôi chẳng học vẽ một tí nào hết, ngoài các con trăn, nhìn bên ngoài hay bổ dọc.	Mert ami festői pályafutásomat illeti, attól már hatesztendős korom­ban elvették a kedvemet a fölnőttek, így aztán nem is tanultam meg rajzolni, kivéve a csukott meg a nyitott óriáskígyókat.
Mắt tròn xoe kinh ngạc, tôi nhìn hình người hiện ra trước mắt.	Ámulattól kerek szemmel néztem hát a különös tüneményt.
Các bạn chớ quên rằng lúc bấy giờ tôi đang cách mọi vùng có người ở là một nghìn dặm nhé.	Ne feledjük el: ezer mérföldre voltam minden lakott vidéktől.
Thế mà cậu bé của tôi không có vẻ gì là bị đi lạc cả, cũng không chết nhọc, chết đói, chết khát, chết sợ.	Emberkémen pedig semmi jele nem volt annak, mintha elté­vedt volna, vagy halálosan fáradt, halálosan éhes, halálosan szomjas lenne, esetleg halálosan félne.
- Nhưng... em đang làm cái gì đây?	- De hát... hogy kerülsz te ide?
Thế là em lặp lại câu lúc nãy, rất dịu dàng, như đó là một điều rất hệ trọng:	Erre szelíden, és mintha valami nagyon komoly dolgot kérne, megismételte:
- Ông làm ơn... hãy vẽ giúp tôi một con cừu.	- Légy szíves, rajzolj nekem egy bárányt...
Khi rõ ràng là bí ẩn quá rồi, ta không dám không tuân theo.	Ha valami nagyon lenyűgözően rejtélyes, az ember nem meri megtenni, hogy ne engedel­meskedjék.
Đang bị tai nạn có thể chết, lại ở một nghìn dặm cách mọi nơi có người, lời yêu cầu đối với tôi lại hết sức vô lí, tôi đành rút từ trong túi ra một tờ giấy và một cây bút máy.	Akármilyen képtelenségnek találtam, hogy ezer mérföldre minden lakott helytől és rá­adásul halálos veszedelemben: elővettem a zsebemből egy darab papirost meg a töltőtolla­mat.
Nhưng tôi liền nhớ ngay rằng mình đã chỉ học môn địa lí, môn sử, môn toán và môn ngữ pháp nhiều nhất, nên tôi nói với cậu bé (tôi hơi khó chịu) rằng tôi không biết vẽ.	Hanem akkor eszembe jutott, hogy én főként földrajzot, történelmet, számtant és nyelv­tant tanultam, és egy kicsit kedvetlenül közöltem az emberkémmel, hogy nem tudok rajzolni.
Em trả lời tôi: - Không hề gì.	- Annyi baj legyen - felelte.
Ông vẽ cho tôi một con cừu.	- Rajzolj nekem egy bárányt.
Tôi ngạc nhiên nghe cậu bé trả lời:	De hogy elképedtem, mikor az emberke azt mondta rá:
- Không!	- Nem!
Không!	Nem!
Tôi không thích con voi trong bụng con trăn đâu.	Nem elefántot akarok óriáskígyóban!
Con trăn nó thật là nguy hiểm, mà con voi thì kềnh càng quá!	Az óriáskígyó nagyon veszedelmes, az elefánt meg olyan behemót nagy.
Ở quê tôi, voi bé tẹo kia.	Nálam odahaza minden apró.
Tôi cần một con cừu.	Nekem bárányka kell.
Vẽ cho tôi một con cừu!	Rajzolj nekem egy bárányt.
Thế là tôi vẽ.	Hát erre rajzoltam egyet.
Em nhìn chăm chú, rồi nói:	Figyelmesen szemügyre vette, aztán:
- Không, con ấy ốm quá rồi.	- Nem! - mondta.
Ông hãy làm con khác.	- Ez már nagyon beteg.
Cậu bạn tôi mỉm cười dễ thương, giọng khoan dung:	Kis barátom kedvesen, de elnézően mosolygott.
- Ông nhìn xem... không phải cừu, nó là dê.	- Jó, jó... Csakhogy ez nem bárány, hanem kos.
Nó có sừng mà...	Ennek szarva van.
Nhưng bức này cũng bị bác như những bức trước:	Ez se volt jó neki, akárcsak az előzők.
- Con ấy nó già quá.	- Nagyon öreg.
Tôi muốn một con cừu sống được lâu cơ.	Nekem olyan bárány kell, amelyik sokáig él.
Và tôi nói to:	- Tessék - mondtam.
- Cái này là cái hòm.	- Ez itt a ládája.
Con cừu em thích nó ở trong đó.	Benne van a bárány, amit akarsz.
Nhưng tôi hết sức kinh ngạc thấy khuôn mặt của vị giám khảo trẻ tuổi của tôi sáng rỡ lên:	Nagy meglepetésemre egyszeriben fölragyogott az arca.
Với con cừu này, có cần nhiều cỏ không ạ?	Mit gondolsz, sok fű kell ennek a báránynak?
- Sao em hỏi thế?	- Miért?
- Vì căn nhà tôi, nó bé tí tẹo mà...	- Hát mert nálam odahaza minden olyan kicsi...
- Chắc là đủ, em ạ. Con cừu tôi cho em cũng chỉ bé tí.	- Biztosan elég lesz neki.
- Chẳng bé quá đâu... Ôi!	- Nem is olyan kicsi... Nézd csak!
Và thế đấy, tôi làm quen với hoàng tử nhỏ.	Így ismerkedtem meg a kis herceggel.
III	3.
Phải rất lâu, tôi mới hiểu em từ đâu đến.	Hosszú időbe tellett, míg megértettem, honnét jött.
Cậu hoàng tử hỏi tôi nhiều câu mà dường như không bao giờ chú ý nghe tôi hỏi.	A kis herceg ugyanis engem elhalmozott kérdésekkel, az enyéimet azonban mintha meg se hallotta volna.
Chỉ là những tiếng ngẫu nhiên buột ra dần dần nói cho tôi hiểu mọi sự.	Lassanként, véletlenül elejtett szavakból tudtam meg, amit megtudtam.
Ví dụ như, khi lần đầu em chợt thấy chiếc máy bay của tôi, (tôi sẽ không vẽ chiếc máy bay đâu: bức vẽ đó sẽ phức tạp hơn nhiều lắm, so với tài vẽ của tôi) em hỏi tôi:	Így mikor először látta meg a repülőmet (nem rajzo­lom le: repülőgépet rajzolni az én számomra túl fogas föladat volna), azt kérdezte:
- Cái kia là vật gì thế ?	- Hát ez meg mi a szösz?
- Không phải vật.	- Ez nem szösz.
Nó là một chiếc máy bay.	Repülőgép.
Đó là chiếc máy bay của tôi.	Az én repülőgépem.
Tôi tự hào nói cho em biết là tôi bay.	Szinte hetvenkedtem neki azzal, hogy repülök.
- Thế ra ông rơi từ trên trời xuống?	- Az égből pottyanttál le?
- Phải - tôi nói khiêm tốn.	- Igen - feleltem szerényen.
- Ôi , đã lạ lùng chưa...	- Hát ez furcsa...
Và hoàng tử bật lên một tiếng cười khanh khách rất xinh nhưng làm tôi cáu lắm.	És fölkacagott, gyöngyöző kacagással; ez határozottan bosszantott.
Tôi muốn ai cũng phải đánh giá nghiêm trọng mọi tai nạn của tôi.	Megkívánom, hogy komo­lyan vegyék a szerencsétlenségeimet.
Cười xong, em nói thêm:	- Szóval te is az égből jöttél?
- Thế là cả ông, ông cũng từ trên trời xuống?	- tette hozzá.
Ông ở hành tinh nào?	- Melyik bolygóról való vagy?
Tức thì tôi thấy lóe lên một tia sáng gì đó, về sự có mặt bí ẩn của em, và đột nhiên tôi hỏi:	Mintha hirtelen fény világította volna meg rejtélyes jelenlétét.
- Thế ra em ở một hành tinh khác tới ?	- Eszerint egy másik bolygóról való vagy?
Nhưng em không trả lời tôi.	- szegeztem neki a kérdést.
- Nhưng mà, ngồi trên cái đó thì ông cũng chẳng thể tới đây, nếu ông ở xa quá...	- Igaz, ezen nem jöhetsz valami messziről...
Rồi em đắm mình mơ màng rất lâu.	És hosszas töprengésbe merült.
Sau đó, móc túi lấy con cừu, em lại ngắm nghía mê mệt của báu đó của mình.	Aztán elővette zsebéből a bárányomat, és kincse szemlélésébe mélyedt.
Các bạn hãy tưởng tượng là tôi bị kích động như thế nào bởi lời tâm sự nửa vời về "các hành tinh khác" ấy.	Képzelhetni, hogy izgatott ez az elharapott vallomás a "másik bolygóról".
Vì vậy, tôi cố tìm hiểu rõ hơn:	Próbáltam hát többet is megtudni.
- Cậu em, em từ đâu đến?	- Honnét jöttél, emberkém?
"Quê em" là đâu thế?	Hol van az az "odahaza"?
Em muốn mang con cừu của ta về đâu.	Hová akarod magaddal vinni a bárá­nyo­mat?
Sau một lát im lặng trầm ngâm, em trả lời tôi:	Tűnődve hallgatott, aztán azt mondta:
- Thuận lợi nhất, với cái thùng ông cho tôi, là ban đêm, cừu có thể dùng nó làm nhà ở.	- Az a jó ebben a ládában, amit adtál, hogy éjszakára háznak is megfelel neki.
- Được chứ.	- Persze, persze.
Em mà ngoan, ta còn cho em một sợi dây để buộc cừu ban ngày.	Ha jó leszel, kötelet is adok, amivel megkötheted.
Và một cái cọc nữa.	Meg egy karót.
Lời đề nghị đó có vẻ làm cậu hoàng tử không vừa lòng:	Ajánlatom szemlátomást meghökkentette a kis herceget.
- Buộc? Ôi!	- Megkötni?
Ngộ nghĩnh chưa!	Milyen ostoba ötlet!
- Nhưng không buộc, nó sẽ đi lung tung, đi lạc...	- De ha nem kötöd meg, elkószál, elvész...
- Nó đi đằng nào được cơ chứ?	Kis barátom erre megint fölkacagott.
- Bất cứ đâu.	- Elkószál?
- Bất cứ đâu.	- Mit tudom én.
Cứ đi thẳng...	Az orra után...
Đến đó, cậu hoàng tử nghiêm trang nhận xét:	A kis herceg elkomolyodott.
- Không hề gì.	- Annyi baj legyen.
IV	4.
Vậy đấy, tôi biết được một điều nữa thật quan trọng: Rằng cái hành tinh quê quán của cậu em chỉ nhỉnh hơn cái nhà có một chút!	Így tudtam meg egy másik fontos dolgot: hogy a bolygó, ahonnét jött, alig nagyobb egy háznál.
Điểu ấy chẳng làm được tôi ngạc nhiên nhiều lắm.	Ezen nem is kellett különösebben csodálkoznom.
Tôi vẫn biết ngoài các hành tinh lớn như Trái Đất, Sao Kim, Sao Hỏa, Sao Thủy, mà người ta đặt tên cho, có hàng trăm ngôi sao khác, đôi khi bé đến nỗi người ta lấy kính nhìn xa ra soi cũng khó thấy.	Hiszen tudtam, hogy a nagy bolygókon kívül, amilyen a Föld, a Jupiter, a Mars, a Vénusz, s aminek mind megvan a maga neve, van még száz és száz más bolygó is, és köztük egyik-másik olyan parányi, hogy távcsövön is csak alig-alig lehet kivenni.
Khi một nhà thiên văn khám phá ra một trong bọn chúng, nhà thiên văn ấy cho nó một con số.	Ha egy csillagász fölfedezi valamelyiket, név helyett egyszerűen számot ad neki.
Ví dụ ông gọi nó là "thiên thạch 3251".	Például elkereszteli "a 3251. kisbolygó"-nak.
Tôi có những lí do chính đáng để tin rằng cái hành tinh của cậu hoàng tử, từ đó cậu đến đây, là thiên thạch B.612.	Minden okom megvan rá, hogy azt higgyem: a bolygó, ahonnét a kis herceg jött, a B-612-es kisbolygó.
Thiên thạch đó chỉ được trông thấy có một lần trong kính nhìn xa, năm 1909, bởi một nhà thiên văn Thổ.	Távcsövön ezt a csillagocskát csak egyetlenegyszer észlelték: 1909-ben egy török csillagász.
Ông ta liền lí giải ồn ào về sự khám phá của mình tại một hội nghị quốc tế về Thiên văn.	Fölfedezéséről akkor nagy előadást tartott a Nemzetközi Csillagászati Kongresszuson.
Nhưng do cách ăn mặc của ông ta, chẳng ai tin điều ông ta nói.	Öltözé­ke miatt azonban nem hitt neki senki.
Người lớn là thế mà!	Mert ilyenek a fölnőttek.
May mắn cho thiên thạch B.612, một nhà độc tài Thổ buộc nhân dân Thổ phải mặc quần áo người u, ai không tuân theo sẽ bị tội chết.	A B-612-es kisbolygó hírnevének nagy szerencséjére azonban egy török diktátor utóbb halál­büntetés terhe mellett megparancsolta népének, hogy öltözködjék európai módra.
Nhà thiên văn làm lại cuộc trình bày năm 1920, trong một bộ quần áo rất lịch sự.	A csillagász 1920-ban megismételte előadását, ezúttal fölöttébb elegáns öltönyben.
Và lần này, tất cả mọi người đồng ý với ông ta.	És ezúttal egyet is értett vele mindenki.
Nếu tôi kể với các bạn tỉ mỉ về thiên thạch B.612, và nếu tôi rỉ tai với các bạn về con số của nó, ấy là tại các người lớn.	Csak a fölnőttek miatt mesélem el ezeket a részleteket a B-612-es kisbolygóról, és a számát is csak miattuk árultam el; a fölnőttek ugyanis szeretik a számokat.
Khi người ta thích có một con cừu, thế là có người ấy chứ!	Egyszerűen ilyenek; még csak haragudni sem kell rájuk miatta.
", họ sẽ nhún vai và cho bạn là trẻ con!	A gyerekeknek nagyon elnézőknek kell lenniük a fölnőttek iránt.
Trẻ con phải hết sức rộng lượng đối với người lớn.	Ezt a történetet is a leg­szívesebben úgy kezdtem volna, mint egy tündérmesét.
Phải, đúng thế.	Ilyesformán:
Thích hơn, giá tôi nói:	"Hol volt, hol nem volt, volt egyszer egy kis herceg.
"Xưa có một lần, một cậu hoàng tử ở một căn nhà chỉ lớn hơn cậu ấy có một tẹo, cậu ấy thấy cần có một người bạn thân..." Đối với những ai hiểu cuộc sống, kể như vậy có vẻ thật hơn nhiều.	Ez a kis herceg egy parányi bolygócskán lakott, olyan parányin, hogy a bolygója alig volt nagyobb nála; ezen a bolygón élt, és nagyon szerette volna, ha van egy jó barátja..." Azoknak, akik értik az életet, ez így sokkal igazabbul hangzott volna.
Bởi vì tôi không muốn người ta đọc cuốn sách của tôi dễ dãi quá.	Mert semmiképp sem szeretném, ha félvállról vennék a könyvemet.
Khi kể lại các kỉ niệm này, tôi tủi cực biết bao.	Hiszen úgy elfog a bánat, mikor ezeket az emlékeimet elmesélem.
Sáu năm đã qua, từ khi cậu bạn thân thiết của tôi đi mất với con cừu của em.	Hat esztendeje már, hogy a barátom búcsút vett tőlem a bárányával.
Nếu tôi thử tả lại em ở đây, chính là để tôi không quên em.	Azért próbálom meg leírni itt, nehogy elfelejtsem.
Một người bạn thân mà mình lại quên thì buồn quá.	Szomorú dolog elfelejteni a barátunkat.
Và dễ tôi lại trở nên như các người lớn chỉ còn thích thú với các chữ số thôi.	S ki tudja, még utóbb belőlem is lehet olyan fölnőttforma ember, akit nem érdekelnek, csak a számok.
Chính cũng vì thế nữa mà tôi đã mua một hộp mầu nước và bút chì màu.	Többek között ezért vásároltam egy doboz festéket meg egy doboz színes ceruzát.
Vào tuổi tôi, bây giờ trở lại nghề vẽ thật là khó, khi tận hồi lên sáu, ngoài con trăn kín với con trăn bổ dọc, tôi đã chẳng hề thử vẽ cái gì khác!	Persze nem könnyű dolog ilyen vén fejjel újra nekifogni a rajzolásnak, mikor egyebet sem próbáltam soha, mint hatesztendős koromban egy nyitott meg egy csukott óriáskígyót!
Tôi sẽ thử, hẳn thế, làm những bức chân dung cố cho thật giống.	De igyekezni fogok, hogy a képeim hasonlítsanak, amennyire csak lehet.
Nhưng tôi không tin hoàn toàn là mình thành công.	Hogy sikerül-e, abban már egyáltalán nem vagyok biztos.
Vẽ bức sau thì bức trước đã không còn giống nó nữa rồi.	Az egyik rajz megjárja, a másik egyáltalán nem.
Tôi lại có hơi nhầm ở vóc dáng.	Elvétem olykor egy kicsit a termet arányait is.
Cái này thì cậu hoàng tử lớn quá.	Emitt a kis herceg túl nagy.
Cái kia em bé quá.	Amott túl kicsi.
Tôi cũng do dự ở màu quần áo của em.	A ruhája színét sem tudom egészen biztosan.
Tôi phải lần mò hoài, như thế này rồi như thế kia, linh tinh.	Így aztán csak tapogatódzom, hol így, hol úgy; lesz, ahogyan lesz.
Nhưng về điều này, các bạn cần tha lỗi cho tôi.	Végül bizonyos fontosabb részleteket illető­leg is tévedni fogok.
Cậu bạn thân tôi không hề giảng giải gì cho tôi.	Ezt azonban meg kell bocsátanotok nekem.
Có lẽ tôi hơi hơi giống các người lớn.	Ki tudja, nem vagyok-e egy kicsit magam is olyan, mint a fölnőttek?
Chắc tôi bắt đầu già.	Alighanem megöregedtem.
V	5.
Mỗi ngày qua, tôi biết thêm một điều về hành tinh, về lúc ra đi, về cuộc đi của cậu.	Naponta megtudtam valamit a bolygójáról, az útrakeléséről, az utazásáról.
Biết lần hồi, theo dòng ngẫu nhiên của suy nghĩ.	Szép lassacskán, egy-egy elejtett megjegyzés jóvoltából.
Như vậy đó, ngày thứ ba thì tôi rõ tấn bi kịch của những cây bao-bá.	Így szereztem tudomást harmadnap a majomkenyérfák drámájáról.
Lần này nữa, cũng là nhờ con cừu, vì đột nhiên, cậu hoàng tử hỏi tôi, rất phân vân:	Ezt is a báránynak köszönhettem, mert a kis herceg, mintha valami súlyos kétsége támadt volna, hirtelen azt kérdezte tőlem:
- Có thật đúng là cừu ăn cây con không?	- Igaz, hogy a bárányok cserjéket esznek?
- Phải.	- Igaz.
Đúng đấy. - Ôi.	- Ó, akkor jól van.
Nhưng cậu hoàng tử nói thêm:	A kis herceg azonban hozzátette:
- Cho nên chúng ăn cả những cây bao-bá chứ?	- Szóval a majomkenyérfákat is megeszik?
Tôi nói rõ với cậu em rằng cây bao-bá không phải loài cây con, mà là những cây to như cả cái nhà thờ, và cậu em có mang theo cả một đàn voi, thì cả đàn voi ấy cũng chẳng làm gì xuể chỉ mỗi một cây bao-bá.	Erre megjegyeztem neki, hogy a majomkenyérfák nem cserjék, hanem hatalmas, templom­torony nagyságú fák, és magával vihetne akár egy csordára való elefántot is: egyetlenegy majomkenyérfával sem bírnának el.
Ý nghĩ về đàn voi làm cho cậu hoàng tử bật cười:	Az elefántcsorda ötlete megnevettette a kis herceget.
- Phải chồng con này lên con kia...	- Egymás tetejébe kellene rakni őket...
Nhưng rất tinh khôn, cậu em nhận xét:	Hanem aztán komolyan azt mondta:
- Bọn bao-bá, trước khi lớn, cũng từng bé tẹo chứ?	- Mielőtt megnőnek, a majomkenyérfák is úgy kezdik, hogy kicsinyek.
- Đúng thế.	- Pontosan így van!
Nhưng sao em lại cứ muốn cho các con cừu của em ăn những cây bao-bá?	De miért akarod, hogy a bárányok megegyék a majomkenyérfákat?
Tôi phải bắt trí thông minh của tôi làm việc dữ dội mới tự tôi hiểu được vấn đề ấy.	Alaposan össze kellett szednem az eszemet, hogy magamtól jussak a probléma nyitjára.
Nhưng không nhìn thấy hạt.	A magvak azonban láthatatlanok.
Chúng ngủ trong huyền bí của đất cho đến khi một cái hạt nào trong bọn chúng thức dậy... Nó vươn vai, rụt rè nảy ra về phía mặt trời một cái nhánh con hiền lành tuyệt xinh.	A föld titkos mélyén alusznak, míg csak az egyiknek eszébe nem jut, hogy fölébredjen... Akkor nyújtózik egyet, és először csak egy elbűvölő, ártatlan kis hajtással kezd félénken a nap felé kapaszkodni.
Mà ngày ấy trên cái hành tinh của cậu hoàng tử thì có nhiều hạt kinh khiếp quá... ấy là những hạt bao-bá.	A kis herceg bolygóján pedig félelmetes magvak voltak: majomkenyérfa-magvak.
Mặt đất hành tinh ô nhiễm đầy hạt bao-bá.	A bolygó egész földjét megfertőzték.
Mà một cây bao bá, nếu như ta đối phó muộn màng quá, ta có thể chẳng bao giờ dẫy nó ra được nữa.	A majomkenyérfával meg úgy van, hogy ha az ember későn kap észbe, soha többé nem bír megszabadulni tőle.
Nó cho rễ của nó xói đục hành tinh.	Egyszerűen elborítja a bolygót.
"Đây là một vấn đề kỉ luật - cậu hoàng tử về sau nói với tôi - Khi ta làm vệ sinh cho ta buổi sáng rồi, ta phải làm kĩ vệ sinh cho hành tinh.	- Fegyelem kérdése - mondta egyszer később a kis herceg. - Miután reggel gondosan rendbe szedte magát az ember, gondosan rendbe kell szednie a bolygóját is.
Đều đặn phải lo việc nhổ bọn bao-bá từ lúc ta còn kịp phân biệt chúng với các cây hoa hồng, mà bao-bá hồi còn thơ thì lại giống cây hoa hồng lắm.	Neki kell látnia, s annak rendje és módja szerint ki kell gyomlálnia a majomkenyérfákat, mihelyt meg tudja különböz­tetni őket a rózsáktól; mert amíg egészen zsengék, nagyon hasonlítanak egymáshoz.
Đó là một việc làm chán lắm, nhưng mà dễ làm".	Igen unal­mas munka, de igen könnyű.
Đến một ngày, cậu em khuyên tôi cố sức vẽ được một bức vẽ đẹp, cho các cậu bé ở quê hương tôi thật nhớ câu chuyện bao-bá ấy.	És egy szép napon azt ajánlotta, próbáljam mindezt lerajzolni, hogy a hazámbeli gyerekek jól megértsék a dolgot.
"Một ngày kia, nếu các bạn ấy lên đường, - cậu em nói với tôi - câu chuyện ấy sẽ có ích cho họ.	- Hasznukra lehet - mondta -, ha egyszer utazni fognak.
Một việc ta hoãn đến hôm sau hãy làm, đôi khi cũng chẳng hại gì.	Néha semmi baj sem származik belőle, ha valamilyen munkát későbbre halasztunk.
Nhưng nếu là những cây bao-bá, thì bao giờ cũng tai họa đấy.	De mindig végzetes következményekkel jár, ha a majomkenyérfákról van szó.
Tôi có biết một hành tinh, trên hành tinh ấy là một cậu bé lười.	Tudok egy bolygót: lusta gazdája volt, figyelmen kívül hagyott három cserjét...
Tôi tuyệt không thích lên giọng dạy đời.	Itt van, ezt a bolygót rajzoltam a kis herceg útmutatásai szerint.
Bài học mà tôi rút ra đáng cho tôi cố công.	A tanulság, melyet nyújtok, megérte a fáradságot.
Khi vẽ cây bao-bá, ý nghĩ về một cái gì rất khẩn cấp thúc giục tôi.	Amikor a majomkenyérfákat rajzoltam, lelkesí­tett az az érzés, hogy sürgősen kell cselekednem ."
VI	6.
Để đùa chơi, bao lâu em chỉ có mỗi ánh dịu dàng khi mặt trời sắp tắt.	Sokáig nem volt egyéb szórakozásod, mint a naplementék szelíd szépsége.
Vào sáng ngày thứ tư thì tôi biết được nét mới đó, khi em bảo tôi:	Ezt az újabb részletet negyednap reggel tudtam meg, amikor azt mondtad:
- Tôi rất thích cảnh mặt trời lặn.	- Nagyon szeretem a naplementéket.
Ta đi xem mặt trời lặn đi.	Gyerünk, nézzünk meg egy naplementét...
- Phải đợi chứ...	- De ahhoz várni kell...
- Đợi cái gì?	- Várni? Mit?
- Đợi lúc mặt trời nó lặn.	- Hát hogy lemenjen a nap.
- Tôi cứ tưởng còn ở nhà!	- Folyton azt hiszem, hogy otthon vagyok!
Thế đấy.	- mondtad.
Khi là buổi trưa ở nước Mỹ thì ai cũng biết là mặt trời đang lặn ở nước Pháp.	Nos: mikor az Egyesült Államokban dél van, Franciaországban köztudomásúlag éppen le­megy a nap.
Chỉ cần đi một phút mà đến được nước Pháp là dự được cảnh mặt trời lặn.	Az embernek elég lenne egyetlen szempillantás alatt Franciaországban teremnie, hogy napnyugtát lásson.
Không may là nước Pháp ở xa quá.	Ehhez azonban Franciaország, sajnos, túlságosan messze van.
Nhưng, trên cái hành tinh bé đến thế của em, em chỉ cần dịch ghế vài bước.	Neked viszont, a parányi bolygódon, egyéb sem kellett, mint pár lépéssel odébb húznod a székedet.
Khi nào em thích là em nhìn thấy mặt trời lặn...	S annyiszor láttad a naplementét, ahányszor csak akartad...
- Có một ngày, tôi thấy mặt trời lặn bốn mươi ba lần!	- Volt egy nap, amikor negyvenháromszor láttam lemenni a napot!
Một chốc sau đó, em nói thêm:	Kisvártatva hozzátetted:
- Ông biết đấy... khi người ta buồn quá, người ta thích cảnh mặt trời lặn...	- Tudod, az ember, ha olyan nagyon-nagyon szomorú, szereti a naplementéket...
- Ngày có bốn mươi ba lần ấy, em buồn đến thế sao ?	- Hát annyira szomorú voltál azon a negyvenháromszoros napon?
Nhưng cậu hoàng tử không trả lời.	Erre azonban a kis herceg nem felelt.
VII	7.
Ngày thứ năm, vẫn là nhờ ở con cừu, tôi biết được cái bí mật ấy của cuộc đời cậu hoàng tử.	Az ötödik napon, változatlanul a bárány jóvoltából, föltárult előttem a kis herceg életének ez a titka is.
Không cần mào đầu, em hỏi giật tôi như hỏi đáp số của một bài tính vốn im lặng suy nghĩ đã lâu rồi:	Hirtelen, minden bevezetés nélkül, mintha előzőleg sokáig töprengett volna a dolgon, halkan azt kérdezte tőlem:
- Một con cừu, nó ăn cây con, tất nó cũng ăn hoa chứ?	- Ha a bárány cserjéket eszik, megeszi a virágokat is?
- Cừu thì gặp cái gì nó ăn cái ấy.	- A bárány mindent megeszik, ami az útjába akad.
- Cả bông hoa có gai nó cũng ăn ư?	- Az olyan virágot is, amelyiknek tüskéje van?
- Phải.	- Igen.
Cả những bông hoa có gai.	Az olyan virágot is, amelyiknek tüskéje van.
- Thế thì gai dùng để làm gì nào?	- Hát akkor mire valók a tüskék?
Tôi không biết.	Mit tudtam én!
Tôi bấy giờ đang rất bận tháo một đinh ốc vặn chặt quá trong chiếc máy của tôi.	Minden figyelmemmel azon igyekeztem, hogy a motorom egyik beszorult csavarját kilazítsam.
Tôi lo quá vì thấy cái máy có vẻ hỏng nặng lắm, mà nước uống thì cạn dần, làm cho tôi sợ xảy ra điều tệ hại nhất.	Tele voltam aggodalommal: gépem hibája egyre súlyosabbnak látszott, ivóvizem meg folyton fogyott, úgyhogy a legrosszabbtól kellett tartanom.
- Gai, gai thì dùng để làm gì?	- Mire valók a tüskék?
Cậu hoàng tử mà đã đặt một câu hỏi nào là không bao giờ chịu bỏ.	Ha egyszer egy kérdést föltett, a kis herceg soha nem tágított tőle többé.
Đang bực mình vì chiếc đinh ốc của tôi, tôi trả lời liều:	Én meg, mert nagyon bosszantott az a csavar, csak úgy vaktában válaszoltam:
- Gai, nó chẳng dùng được vào việc gì sất.	- A tövisek nem valók semmire.
Nó chỉ là cái áo của loài hoa thôi!	A tövis puszta gonoszság a virág részéről.
- Ôi chao!	- Ó!
Nhưng sau một lát lặng im, cậu em chảu môi lại phía tôi, vẻ hờn đỗi:	- De némi hallgatás után, már-már ingerülten vetette oda: - Nem hiszem!
- Tôi không tin!	A virágok gyöngék.
Loài hoa, chúng yếu lắm.	Gyanútlanok.
Chúng ngây thơ lắm.	Úgy védekeznek ahogy tudnak.
Chỉ là chúng cố tự làm cho chúng được vững tâm.	Félelmetesnek képzelik magukat a tüskéikkel.
- Ông, ông cho rằng loài hoa...	- És te, mondd, te is azt hiszed...
- Không, không mà!	- Nem!
Tôi có cho là gì đâu!	Nem! Nem hiszek semmit.
Tôi trả lời linh tinh thế thôi.	Csak úgy mondtam.
Tôi, tôi đang bận vì những việc hệ trọng mà!	Én komoly dolgokkal foglalkozom.
Cậu nhìn tôi ngạc nhiên:	Elképedve nézett rám.
- Những việc hệ trọng!	- Komoly dolgokkal?
Cậu em nhìn thấy tôi tay cầm búa, các ngón đen nhẻm vì dầu máy, cúi xuống một vật đối với cậu xấu xí lắm.	Látta, ahogy kezemben a kalapáccsal, olajtól fekete ujjakkal görnyedek valami fölé, amit szerfölött rondának talált.
- Ông lại nói như các người lớn mất thôi!	- Úgy beszélsz, mint a fölnőttek.
Cậu ấy có hơi làm cho tôi xấu hổ.	Erre elszégyelltem magam.
Nhưng, không xót thương, cậu em nói thêm:	Ő azonban könyörtelenül hozzátette:
- Ông lẫn lộn hết... ông xáo trộn hết!	- Mindent összezavarsz... Mindent összekeversz...
Cậu em thực sự bực tức.	Szemlátomást nagyon haragudott.
Em xõa tung ra trước gió mái tóc vàng óng:	Megrázta aranyhaját a szélben.
- Tôi có biết một hành tinh, trên đó có một ông mặt mũi đỏ gay.	- Tudok egy bolygót, egy vörös képű uraság lakik rajta.
Ông ta không hề hít một bông hoa.	Az soha egyetlen virágot meg nem szagolt életében.
Không hề nhìn một vì sao.	Soha egyetlen csillagot meg nem nézett.
Không hề yêu một người nào.	Soha senkit nem szeretett.
Chẳng bao giờ làm cái gì khác những bài tính cộng.	Soha nem csinált egyebet, mint folyton csak számolt.
Thế mà suốt ngày, ông ta cứ lặp đi lặp lại như hệt ông: "Tôi là một người đứng đắn!	És egész álló nap azt hajtogatta, amit te mondtál az imént: "Én komoly ember vagyok!
Tôi là một người đứng đắn!	Én komoly ember vagyok!", és csak úgy dagadt a kevélységtől.
- Cái gì?	- Micsoda!
- Cái nấm!	- Gomba!
Bây giờ, mặt cậu hoàng tử tái xanh vì giận dữ.	A kis herceg most egészen sápadt volt az indulattól.
- Đã hàng triệu năm nay, loài hoa sản xuất nên gai.	- Millió és millió éve, hogy a virágok tüskéket gyártanak.
Hàng triệu năm nay, loài cừu vẫn cứ ăn hoa.	Millió és millió éve, hogy a bárá­nyok mégis megeszik a virágokat.
Vậy mà tìm hiểu xem vì sao hoa lại cứ phải gian khổ biết bao sản xuất những cái gai vô tích sự ấy, tìm hiểu điều ấy, lại là chuyện không đứng đắn hay sao?	Hát akkor miért ne volna komoly dolog, ha meg akarjuk érteni, mi végre a sok fáradozás, amivel olyan tüskéket csinálnak maguknak, amelyek soha semmire sem jók?
Chiến tranh giữa loài cừu và loài hoa là chuyện không quan trọng hay sao?	A bárányok és a virágok háborúja talán nem fontos?
Không đứng đắn hơn, không quan trọng hơn những bài tính cộng của một cái ông to tướng mặt mũi đỏ gay hay sao?	Nem komolyabb és nem fontosabb, mint annak a kövér, vörös úrnak a számadásai?
Và tôi biết một cái hoa duy nhất trên đời không đâu có nó, ngoài cái hành tinh của tôi, thế mà một con cừu nhỏ có thể táp một cái như thế, và hủy nó, một sáng nào đó, rồi không mảy may chú ý là mình vừa làm cái gì, chuyện đó không quan trọng hay sao?	És ha én tudok egy virágot, egy egyetlen virágot az egész világon, olyat, amilyen sehol másutt nem létezik, egyedül csak az én bolygómon, aztán egy bárányka egy csapásra megsemmisítheti, csak úgy, anélkül, hogy akár csak sejtené is, hogy mit művel: ez talán nem fontos?
Em đỏ mặt nói tiếp:	Elpirult, folytatta:
- Khi một người yêu một đóa hoa, hoa ấy chỉ có một đóa thôi, trong hàng triệu hàng triệu ngôi sao, chừng ấy đủ làm cho anh sung sướng khi nhìn những ngôi sao.	- Ha valaki szeret egy virágot, amely csak egyetlen példányban létezik a csillagmilliókon: ez épp elég neki, hogy boldog legyen, ha a csillagokra pillant.
Và chuyện đó không quan trọng hay sao?	És ez talán nem fontos?
Cậu em không nói được gì thêm.	Többet nem bírt mondani.
Thốt nhiên em bật lên nức nở.	Váratlanul kitört belőle a zokogás.
Đêm đã buông xuống.	Közben már leszállt az éjszaka.
Tôi đã bỏ các đồ nghề ra.	Letettem a szerszámaimat.
Tôi cóc cần cái búa của tôi, cái đinh ốc của tôi, cóc cần cái khát, cóc cần cái chết.	Bántam is én a kalapácsomat, a csavart, a szomjúságot és a halált!
Trên một ngôi sao, một hành tinh, hành tinh của tôi, Trái Đất, có một hành tinh bé nhỏ cần được an ủi!	Egy csillagon, egy bolygón, az enyémen, a Földön volt egy kis herceg, akit meg kellett vigasztalni!
Tôi ôm em trong vòng tay tôi.	A karomba vettem, ringatni kezdtem.
Tôi cảm thấy tôi rất vụng về.	Nagyon ügyetlennek éreztem magam.
Tôi không biết làm sao đạt được đến em, đi đâu thì gặp lại em... Thật huyền bí làm sao, xứ sở của nước mắt.	Nem tudtam, hogyan férkőzzem hozzá, hogyan találjak közösséget vele... Olyan titokzatos világ a könnyek országa.
VIII	8.
Tôi tìm biết rất nhanh và rõ hơn về đóa hoa này.	Rövidesen jobban is megismerhettem ezt a virágot.
Trên hành tinh của cậu hoàng tử, vẫn có những bông hoa rất đơn giản, điểm trang bằng chỉ một hàng cánh, tuyệt chẳng chiếm nơi chiếm chỗ gì, và chẳng làm phiền ai.	A kis herceg bolygóján mindig voltak virágok, nagyon egyszerű virágok, egy sor szirommal, helyet is alig foglaltak, és nem zavartak senkit.
Một buổi sáng, chúng lộ ra trong cỏ rồi lại chết lịm đi vào chiều tối.	Reggel megjelentek a fűben, estére elhervadtak.
Nhưng cái hoa ấy, một ngày kia, đã nảy mầm từ một cái hạt, không biết từ đâu mang tới, và cậu hoàng tử đã chăm sóc rất sít sao cái nhánh con không giống với các nhánh con nào khác.	De ez egy szép napon egyszerre csak kicsírázott, magva a jó ég tudja, honnét került oda, és a kis herceg aprólékos gonddal figyelte a zsenge hajtást, amelyik semmilyen más hajtáshoz sem hasonlított.
Nó có thể là một loại bao-bá mới.	Ki tudja, nem holmi majom­kenyérfa-féleség-e?
Nhưng cái cây nhỏ liền thôi không lớn lên nữa, và bắt đầu sửa soạn để ra hoa.	A vesszőcske növekedése azonban abbamaradt, és a kis növény hozzákezdett a virágkészítéshez.
Cậu hoàng tử, chứng kiến sự xuất hiện một cái nụ, cảm thấy rõ ràng từ cái nụ này sẽ lộ ra một điều kì diệu, nhưng đóa hoa vẫn cứ điểm trang hoài, nấp kín trong căn buồng xanh của nó.	A kis herceg szemmel kísérte, hogyan jelenik meg rajta egy óriási bimbó, és sejtette, hogy csodálatos tünemény fog kibontakozni belőle; a virág azonban végevárhatatlanul, egyre csak szépítgette magát odabent a zöld szobájában.
Hoa chọn lựa kĩ màu sắc của mình.	Nagy gonddal válogatta meg a színeit.
Hoa chậm rãi mặc áo mặc quần, gấp xếp thẳng thớm từng cánh một.	Lassan öltözködött, egyenként igazította magára a szirmait.
Hoa không muốn đi ra ngoài mà nhàu nát như các chị mồng gà.	Nyilván nem akart olyan gyűrötten napvilágra lépni, mint a pipacsok.
Hoa chỉ muốn ra đời trong hoàn cảnh rỡ ràng hương sắc.	Nem akart megmutatkozni, csak szépsége teljes sugárzásában.
Ôi chao!	Úgy bizony!
Hoa thật là điệu!	Nagyon kacér virág volt!
Cuộc trang điểm huyền bí của nó kéo dài rất nhiều ngày, rất nhiều ngày.	Így aztán hosszú napokon át tartott a titokzatos öltözködése.
Và rồi tới một sớm mai, đúng giờ mặt trời mọc, nó hiện ra.	Aztán egy hajnalban, éppen napkeltekor, végre megjelent.
Và cô ả, vốn đã chăm chút tỉa tót đến như thế, bây giờ vừa ngáp vừa nói:	Ásított egyet, és azt mondta, ő, aki olyan aggályos pontossággal dolgozott:
Thế là cậu hoàng tử không nén nổi khâm phục:	A kis herceg nem bírta magába fojtani a csodálkozását:
- Cô em đẹp thế!	- Milyen szép vagy!
- Thật ư anh - hoa trả lời dịu dàng.	- Ugye? - felelte kedvesen a virág.
- Em sinh cùng lúc với mặt trời, anh biết không...	- És épp egyszerre születtem a nappal...
Cậu hoàng tử đoán biết cô ả không lấy gì làm khiêm tốn lắm nhưng cô thật dễ làm cho người ta xúc động!	A kis herceg ebből könnyen kitalálta, hogy a virág nem valami szerény; viszont olyan meg­ható volt!
- Đã đến giờ điểm tâm, hình như thế phải không anh, - cô ả nói thêm ngay sau đó, - xin anh hãy nhớ đến em...	- Azt hiszem, épp most van a reggeli ideje - tette hozzá a virág kisvártatva. - Volnál szíves gondoskodni rólam?
Thế là cậu hoàng tử, xấu hổ quá, đi lấy một chiếc ô-doa nước lã và dọn lên cho bông hoa.	A kis herceg pedig, mélységes zavarban, sietve kerített egy öntözőkannát, és kiszolgálta a virágot.
Như vậy đấy, cô ả đã làm cho cậu em lo nghĩ nhiều và nhanh chóng với tính kiêu kì hơi u ám của cô.	Az meg már mindjárt az elején zaklatni kezdte az ijedős hiúságával.
Chẳng hạn một hôm, cô đã nói với cậu hoàng tử về bốn cái gai của mình:	Egy napon például, mikor a négy töviséről beszélt, azt mondta a kis hercegnek:
- Chúng có thể tới đây, lũ hổ ấy, móng vuốt dễ sợ...	- Most aztán jöhetnek a tigrisek a karmaikkal!
- Trên hành tinh của anh không có hổ - cậu hoàng tử nhận xét.	- Az én bolygómon nincsenek tigrisek - jegyezte meg erre a kis herceg.
- Vả lại, hổ không ăn cỏ mà.	- A tigrisek különben sem esznek füvet.
- Em có phải là cỏ đâu - bông hoa đáp lại dịu dàng.	- Én nem vagyok fű - felelte szelíden a virág.
- Xin lỗi cô...	- Bocsáss meg...
- Em chẳng sợ gì hổ, nhưng em khiếp các luồng gió.	- Különben sem félek a tigrisektől. A huzattól viszont irtózom.
Anh có một tấm chắn gió nào không anh?	Nincs véletlenül valamilyen szélfogód?
"Khiếp các luồng gió... đối với một cái cây nhỏ thế là không hay - cậu hoàng tử nhận xét.	"Irtózni a huzattól - gondolta a kis herceg - elég kockázatos kilátás egy növénynek.
Cô ả hoa này khó tính đây..."	- Furcsa egy virág ez..."
- Chiều tối, anh hãy đặt em trong bầu kính nhé.	- Esténként tégy majd bura alá.
Quê anh rét lắm.	Nagyon hideg van itt nálad.
Thiếu tiện nghi quá.	Rosszul vagy berendezkedve.
Ở chỗ của em ấy ư...	Ahonnét én jöttem...
Nhưng cô ả nín bặt.	De nem folytatta.
Cô ta chẳng thể hiểu được điều gì về các thế giới khác.	Hiszen mag formájában jött: más világokról nem tudhatott semmit.
Ngượng vì lỡ mà để bị bắt gặp là mình nói dối đến ngây ngô quá như thế, cô húng hắng ho hai ba lượt, để nhắc lại cho cậu hoàng tử biết cậu thật không chu đáo:	Szégyenében, hogy ilyen együgyű füllentésen kapatta rajta magát, kettőt-hármat köhintett, így akart fölébe kerekedni a kis hercegnek.
- Cái chắn gió, anh có không?...	- A szélfogó?
- Anh đã định đi lấy thì em bắt đầu nói!	- Épp azért indultam, de elkezdtél beszélni hozzám...
Tuy vậy cô ả vẫn ho nữa để buộc cậu phải biết lỗi.	Erre a virág még jobban köhécselt, hadd furdalja csak a lelkiismeret a kis herceget.
Cậu hoàng tử, như vậy đấy, đã ngờ ngay về cô ả mặc dù rất quý cô, cậu vẫn đối xử với cô rất tốt.	Annak pedig, hiába volt tele jóakaró szeretettel, előbb-utóbb mégiscsak megrendült a bizalma a virágban.
Cậu đã suy nghĩ nghiêm trang về những lời tưởng không quan trọng gì của cô, và khổ lắm.	Minden lényegtelen megjegyzést a szívére vett, és kezdte nagyon-nagyon boldogtalannak érezni magát.
"Đáng lẽ tôi không nên căn cứ vào những điều mình nghe, không bao giờ nên nghe loài hoa cả - một hôm cậu em tâm sự với tôi.	- Nem lett volna szabad meghallgatnom - vallotta meg egy napon. - A virágok szavát sosem szabad meghallgatni.
Chỉ nên nhìn chúng, hít mùi hương của chúng thôi.	Nézni kell őket, beszívni az illatukat.
Cái hoa của tôi làm thơm ngát hành tinh của tôi, nhưng tôi lại không vui vì thế.	Az enyém egész bolygómat elárasztotta az illatával, mégse tudtam örülni neki.
Câu chuyện móng vuốt ấy đáng lẽ làm cho tôi mềm lòng thì tôi lại bực..."	Annyira bosszantott az a tigriskarom-história, holott inkább meg kellett volna hatódnom rajta...
- Ngày ấy, tôi chẳng biết cách tìm hiểu gì cả.	- Bizony, nagyon értelmetlen voltam én akkor!
Đáng lẽ tôi phải xét đoán cô ả trên việc làm chứ không phải bằng vào lời nói.	A tetteiből kellett volna megítélnem, nem a szavaiból.
Cô tỏa thơm tôi, làm cho tôi sáng rực lên.	Beburkolt az illatával, elborított a ragyogásával.
Đáng lẽ tôi không nên bao giờ bỏ đi cả!	Sosem lett volna szabad meg­szöknöm!
Đáng lẽ tôi phải đoán được tình cảm chân thật của cô đằng sau mọi mánh khóe vặt vãnh ấy.	Szegényes kis csalafintaságai mögött meg kellett volna éreznem gyöngéd szeretetét.
Loài hoa, họ hay trái tính trái nết lắm.	Minden virág csupa ellentmondás.
Lúc bấy giờ tôi còn trẻ quá nên chẳng biết quý người.	De én még sokkal fiatalabb voltam, semhogy szeretni tudtam volna!
IX	9.
Buổi sáng hôm ra đi, em đã dọn dẹp hành tinh thật ngăn nắp.	Szökéséhez, azt hiszem, a vadmadarak húzását használta föl.
Em nạo vét kĩ càng các quả núi lửa đang hoạt động của em.	Indulása reggelén szépen rendbe tette a bolygóját.
Em có hai quả núi lửa đang hoạt động.	Gondosan kipucolta a működő vulkánjait.
Và chúng rất thuận tiện cho việc thổi nấu bữa sáng.	Két ilyen működő vulkánja volt szerencsére: kényelmesen megfőzhette rajtuk a reggelijét.
nên em cũng nạo vét cả quả núi lửa đã tắt nữa.	De mert úgy gondolta: "Sosem lehet tudni!", kipucolta ezt a kialudt vulkánt is.
Được nạo vét kĩ, các quả núi lửa sẽ cháy nhỏ thôi, liu riu thôi, không gây nên động đất đâu.	A vulkánok, ha jól kipucolják őket, szabályosan, enyhe lánggal égnek, kitörések nélkül.
Các cuộc động đất do núi lửa cũng giống như lửa trong lò sưởi của ta ấy mà.	A vulkánkitörések olyanok, mint a mi kéménytüzeink.
Tất nhiên là trên trái đất của chúng ta, chúng ta thật bé nhỏ quá, không nạo vét được các quả núi lửa của mình.	Mi itt a Földön nyilván túl kicsinyek vagyunk hozzá, hogy rendesen kipucoljuk a vulkánjainkat.
Cậu hoàng tử cũng bứt những búp măng vừa nhú của các cây bao-bá, lòng hơi man mác.	A kis herceg némi kis szomorúsággal kigyomlálta az utolsó majomkenyérfa-hajtásokat is.
Em đã ngỡ rồi đây không bao giờ về nữa.	Szentül hitte, hogy soha nem fog visszatérni többé.
Nhưng mọi việc quen thuộc này vào buổi sáng hôm nay đối với em thật vô cùng êm đềm.	De aznap reggel nagyon-nagyon jólestek neki ezek a megszokott munkák.
Đến khi em tưới đóa hoa lần sau chót, sắp sửa cất kĩ nó trong bầu kính, em bắt gặp em muốn khóc.	S amikor utoljára öntözte meg a virágot, és be akarta borítani a burájával, egyszeriben sírhatnékja támadt.
- Từ biệt, - em nói với hoa.	- Isten veled - mondta a virágnak.
Nhưng cô ả không đáp.	A virág azonban nem felelt.
- Từ biệt, - em lặp lại.	- Isten veled - ismételte.
Hoa ho lên.	A virág köhintett.
Không phải vì bị viêm họng.	Ezúttal azonban nem azért, mintha megfázott volna.
- Em đã dại lắm, - sau cùng cô nói.	- Ostoba voltam - mondta végül a kis hercegnek.
- Anh tha lỗi cho em.	- Kérlek, ne haragudjál rám.
Chúc anh hạnh phúc.	Próbálj meg boldog lenni.
Cậu hoàng tử ngạc nhiên vì không thấy cô trách móc.	A kis herceget meglepte, hogy nem kap semmiféle szemrehányást.
Em đứng sững, tay cầm nguyên cái bầu kính.	Tanácstalanul állt, kezében a burával.
Thái độ dịu dàng bình thản ấy của cô, em không hiểu được.	Sehogy sem értette a virágnak ezt a kedves szelídségét.
- Có chứ, em có yêu anh chứ, - hoa nói với cậu hoàng tử.	- Hát igen, szeretlek - mondta a virág.
Thế mà anh chẳng biết gì cả, ấy là lỗi tại em.	- Te persze még csak nem is sejtetted, de ebben én vagyok a hibás.
Điều ấy nào có quan trọng gì.	Különben nem is fontos.
Thôi, anh hãy để yên cái bầu kính đó.	Próbálj meg boldog lenni... Hagyd békén azt a burát.
- Thế gió nó...	- De a szél...
- Em có bị sổ mũi nhiều đâu... Gió mát ban đêm hay cho em chứ. Em là một cái hoa mà.	- Egyáltalán nem vagyok olyan náthás... Virág vagyok: jót fog tenni az éjszaka hűs levegője.
- Còn bọn thú nữa...	- De az állatok...
- Em muốn biết bươm bướm là thế nào, em phải chịu đựng vài ba con sâu.	- Két-három hernyót el kell tűrnöm, ha meg akarom ismerni a pillangókat.
Hình như lũ bướm ấy thật là đẹp.	Állítólag olyan szépek.
Nếu không, rồi ai sẽ viếng thăm em?	Meg aztán ki más látogatna meg?
Còn bọn thú dữ, em có lo gì.	A vad­állatoktól pedig egy csöppet sem félek.
Em có móng vuốt của em.	Nekem is vannak karmaim.
- Anh chớ có chần chừ thế, khó chịu lắm.	- Ne ácsorogj itt ilyen ügyefogyottan - tette hozzá.
Anh đã quyết đi thì hãy đi đi.	- Idegesítő... Elhatároztad, hogy elmégy.
Đóa hoa ấy nó vô cùng kiêu hãnh.	Kevély virág volt.
X	10.
- Ôi!	- Hohó!
Đây, một thần dân!	Itt egy alattvaló!
- Ông vua kêu lên thế khi nhác thấy cậu hoàng tử.	- kiáltott föl, amikor megpillantotta a kis herceget.
Cậu hoàng tử đưa mắt tìm chỗ ngồi, nhưng cái áo choàng lông thú tuyệt đẹp choán hết chỗ của hành tinh.	A kis herceg körülnézett, hová ülhetne le, de a bolygót mindenestül beborította a pompás hermelin palást.
Thế nên em phải đứng, và nhọc quá, em ngáp một cái.	Állva maradt hát, és mert fáradt volt, ásított egyet.
- Đứng trước một bậc đế vương mà ngáp là không đúng lễ - vua phán.	- Az etikett megtiltja, hogy a király jelenlétében ásítsanak - mondta az uralkodó.
- Ta cấm ngươi ngáp.	- Megtiltom.
- Chỉ là vì tôi không giữ được ạ, - cậu hoàng tử rất ngượng đáp lại.	- Nem bírom megállni ásítás nélkül - felelte a kis herceg zavartan.
- Tôi từ xa đến đây, chưa được ngủ...	- Nagy utat tettem meg, és nem aludtam...
- Thế thì, - vua lại phán - ta ra lệnh cho ngươi ngáp.	- Akkor megparancsolom, hogy ásíts - mondta a király.
Bao nhiêu năm nay, ta chưa được thấy ai ngáp.	- Hosszú esztendők óta senkit sem láttam ásítani.
Ngáp đối với ta là trò hiếm đấy.	Az ilyesmi ritka szórakozás nekem.
Ngươi ngáp nữa đi.	Tessék, ásíts még egyet!
Đó là lệnh ta.	Parancsolom.
- Tôi mất tự nhiên rồi... không ngáp được nữa... - Cậu hoàng tử nói, mặt đỏ bừng.	- Csakhogy ettől lámpalázas lettem.
- Lại thế!	Nem megy... - felelte a kis herceg, és elpirult.
- Vua đáp.	- Hm... hm... - tűnődött a király.
- Thế thì... ta ra lệnh cho ngươi vừa ngáp vừa...	- Hát akkor... megparancsolom, hogy hol ásíts, hol meg...
Nhà vua nói hơi lắp và có vẻ phật ý.	Dünnyögött valamit, szemlátomást feszengve.
Vì vua chú trọng nhất vào điều uy quyền của mình phải được tuân theo.	Mert a király föltétlenül ragaszkodott hozzá, hogy tiszteljék a királyi tekintélyét.
Nhưng, vì ông ta nhát lắm, nên ông ta cũng ra những cái lệnh hợp tình hợp lí thôi.	De mivel ugyanakkor jóságos is volt, értelmes parancsokat osztogatott.
Ông thường nói như thế này: "Nếu ta mà ra lệnh cho một võ tướng phải biến thành chim biển, và võ tướng ấy chẳng tuân lệnh ta, thì ấy không phải là lỗi của võ tướng đó.	"Ha egy generálisnak megparancsolnám - mondogatta -, hogy változzék tengeri madárrá, és a generális nem engedelmeskednék: ebben nem ő lenne a hibás.
Ấy là lỗi của ta".	Én lennék a hibás miatta."
- Tôi ngồi được không ạ?	- Leülhetek?
- Cậu hoàng tử rụt rè hỏi.	- kérdezte a kis herceg félénken.
- Ta lệnh cho ngươi ngồi - vua đáp lại, vừa kéo lại về phía chân mình một vạt áo lông thú.	- Parancsolom, hogy ülj le - felelte a király, és méltóságteljesen odébb húzta egy kicsit a hermelin palástja szegélyét.
Thế thì ông vua trị vì cái gì?	Vajon min uralkodik akkor a király?
- Thưa bệ hạ, - cậu nói - cúi xin bệ hạ tha tội cho tôi được hỏi...	- Fölség - mondta -, engedelmet kérek, de kérdeznék fölségedtől valamit...
- Ta lệnh cho ngươi hỏi - vua vội vàng nói.	- Parancsolom, hogy kérdezz tőlem valamit - mondta sietve a király.
- Tâu bệ hạ, bệ hạ trị vì cái gì ?	- Fölséged... min uralkodik?
Nhà vua đáp, hết sức giản dị:	- Mindenen - válaszolta mérhetetlen egyszerűséggel a király.
- Muôn vật.	- Mindenen?
- Tất cả muôn vật này?	- Ezen mind?
- Cậu hoàng tử nói.	- kérdezte a kis herceg.
- Tất cả muôn vật này... - Vua trả lời.	- Ezen mind - felelte a király.
Bởi vì đó không những là một vị vua chuyên chế mà còn là một vị vua phổ biến nữa.	Mert nemcsak abszolút uralkodó volt, hanem egyetemes is.
- Các ngôi sao, chúng nó tuân lệnh bệ hạ không ạ?	- És a csillagok engedelmeskednek fölségednek?
- Hẳn chứ - vua trả lời em.	- Természetesen - mondta a király.
- Chúng tuân ngay lập tức.	- Azon nyomban.
Trẫm không dung tha sự bất tuân.	Semmi fegyelmezetlenséget nem tűrök.
Quyền lực như thế làm cho cậu hoàng tử mê thích lắm.	A kis herceg elámult ekkora nagy hatalmon.
Nếu bản thân em mà có quyền lực ấy, em mặc sức chứng kiến, không phải bốn mươi bốn, mà bảy mươi hai, dễ đến một trăm, hai trăm cảnh mặt trời lặn trong một ngày, mà chẳng phải dịch ghế bao giờ hết.	Ha neki ilyen hatalma lenne, napjában nem negy­vennégy naplementét láthatna, hanem hetvenkettőt, sőt százat vagy akár kétszázat is, és még csak odébb se kellene húznia a székét!
Rồi em cảm thấy hơi buồn vì chợt nghĩ đến cái hành tinh nhỏ giờ vắng vẻ của mình, em đánh bạo xin nhà vua ân huệ:	S mivel egy kicsit szomorú volt, mert eszébe jutott az elhagyott bolygócskája, olyannyira nekibátorodott, hogy egy kegyet merészelt kérni a királytól:
- Tôi ao ước được xem một cảnh mặt trời lặn... Bệ hạ thi ân cho, hãy ra lệnh cho mặt trời lặn...	- Úgy szeretnék naplementét látni... Örvendeztessen meg fölséged. Parancsolja meg a napnak, hogy nyugodjék le...
- Nếu ta ra lệnh cho một võ tướng bay từ đóa hoa này sang đóa hoa kia như một con bướm, hay lệnh cho ông ta viết một vở kịch, hay biến thành chim biển, và nếu vị võ tướng ấy không tuân lệnh, thì lỗi ấy là ở ông ta hay là ở ta?	- Ha egy generálisnak azt parancsolnám, szálljon virágról virágra, mint egy lepke, vagy írjon egy tragédiát, vagy változzék tengeri madárrá, és a generális nem hajtaná végre a parancsot, ki lenne a hibás emiatt: ő vagy én? - Fölséged!
- Muôn tâu, ở bệ hạ - cậu hoàng tử nói cả quyết.	- jelentette ki a kis herceg nagy határozottsággal.
- Đúng.	- Látod.
Phải buộc người nào làm việc người đó có thể làm - vua nói thêm.	Mindenkitől azt kell követelni, amit az illető megtehet.
- Uy quyền trước hết dựa trên lẽ phải.	A tekintély legelső alapja az értelem - mondta a király.
Nếu nhà ngươi ra lệnh cho thần dân của mình nhảy xuống bể, cách mạng tất sẽ nổ ra.	- Ha népednek azt parancsolod, vesse magát a tengerbe: föllázad, forradalmat csinál.
Ta có quyển buộc tuân lệnh ta vì mọi lệnh ta đều hợp lẽ.	Azért van jogom engedelmességet követelni, mert ésszerűek a parancsaim.
- Thế nhưng cảnh mặt trời lặn mà tôi xin bệ hạ ban cho ạ?	- Akkor mi lesz a naplementémmel?
- cậu hoàng tử vốn đã đặt ra câu hỏi gì thì không bao giờ quên, hỏi lại.	- firtatta a kis herceg, mert ha már föltett egy kérdést, többé nem tágított tőle.
- Cảnh mặt trời lặn nhà ngươi xin, nhà ngươi sẽ có.	- Meg fogod kapni a naplementédet.
Ta muốn thế.	Követelem.
- cậu hoàng tử hỏi.	- És az mikor lesz?
- Để xem... để xem!	- tudakolta a kis herceg.
- nhà vua nói, thoạt tiên tra một cuốn lịch to tướng, để xem, để xem...!	- Hm... hm... - felelte a király, és böngészni kezdett egy testes naptárban.
Vào lúc... vào lúc... chiểu nay, bảy giờ bốn mươi phút!	- Hm... hm... mikor lesz... mikor lesz... ma este, hét óra negyven perc körül.
Nhà ngươi sẽ được thấy có phải lệnh ta được tuân theo đúng đắn không.	És majd meglátod, milyen híven engedelmeskednek nekem.
Cậu hoàng tử ngáp.	A kis herceg ásított.
Em tiếc sẽ bỏ nhỡ cảnh mặt trời lặn.	Sajnálta, hogy oda a napnyugtája.
Và em cũng đã bắt đầu thấy chán:	Ráadásul egy kicsit unatkozott is már.
- Tâu bệ hạ, tôi chẳng có việc gì ở đây nữa, xin bệ hạ cho tôi lại ra đi.	- Nincs itt semmi dolgom többet - mondta a királynak.
- cậu nói với nhà vua.	- Megyek tovább. - Ne menj!
- Ngươi chớ đi - nhà vua vừa mới kiêu hãnh xiết bao vì có được một thần dân, đáp lời hoàng tử.	- mondta a király, hiszen olyan büszke volt rá, hogy végre akadt egy alattvalója.
- Chớ đi, ta phong ngươi làm thượng thư!	- Ne menj el, megteszlek miniszternek.
- Tâu, thượng thư bộ gì ạ?	- Milyen miniszternek?
- Bộ... bộ tư pháp!	- Hát... igazságügyinek!
- Nhưng có ai để xét xử đâu ạ?	- De ha nincs, akinek igazságot szolgáltassak!
- Chưa thể biết, - vua nói với cậu hoàng tử.	- Sosem lehet tudni - felelte a király.
- Ta chưa đi tuần tra khắp vương quốc của ta.	- Még nem jártam be a királyságomat.
Ta già quá rồi, chẳng có cỗ xa giá nào cho ta, mà đi bộ thì ta nhọc lắm.	Öreg vagyok, hintóra nincs helyem, a gyaloglás meg fáraszt.
- Lại thế!	- Ó, hiszen már láttam!
Nhưng tôi đã nhìn thấy rõ - cậu hoàng tử nghiêng mình nhìn sang phía bên kia của hành tinh.	- mondta a kis herceg, és előrehajolt, hogy egy pillantást vessen a bolygó túlsó felére.
- Bên kia cũng chẳng có ai đâu ạ...	- Ott sincs senki.
- Có hay không, tùy nhà ngươi xét.	- Hát akkor ítélkezzél saját magadon - mondta a király.
- Vua đáp lại em.	- Ez a legnehezebb.
Nếu ngươi xét được mình đúng đắn, thì ngươi là một bậc hiền nhân chân chính.	Ha sikerül helyesen ítélkezned saját magad fölött, az annak a jele, hogy valódi bölcs vagy.
- Cậu hoàng tử đáp lại. - Tôi không nhất thiết phải ở đây.	- De ítélkezni mindenütt ítélkezhetem magam fölött - jegyezte meg a kis herceg.
- Để xem!	- Ahhoz nem kell itt laknom.
Để xem! - Vua nói.	- Hm... hm... - mondta a király.
- Hình như trên hành tinh của ta, đâu đó có một con chuột.	- Azt hiszem, van itt valahol a bolygómon egy vén patkány.
Nhà ngươi có thể xét con chuột ấy.	Éjszaka hallom a motozását.
Thỉnh thoảng ngươi nên ghép nó vào tội tử hình.	Hát ítélkezzél e fölött a vén patkány fölött.
Như thế, cuộc đời của nó sẽ tùy ở luật pháp của nhà ngươi.	Időről időre halálra ítéled; élete így a te igazságszolgáltatásodtól függ majd.
- Tôi không thích buộc tội tử hình, - cậu hoàng tử đáp lại - và tôi nhất thiết phải từ biệt bệ hạ.	- Nem szeretem a halálos ítéleteket - mondta a kis herceg -, és minden bizonnyal elmegyek. - Ne!
- Không - vua nói.	- mondta a király.
Nhưng cậu hoàng tử đã sửa soạn xong, không muốn làm phiền lòng vị vua già một chút nào hết:	A kis herceg azonban nekifogott az előkészületeknek, majd, mivel nem akart fájdalmat okozni az öreg uralkodónak, így szólt:
- Nếu bệ hạ muốn được tuân theo một cách đúng đắn, bệ hạ hãy cho tôi một cái lệnh hợp lẽ.	- Ha fölségednek az a kívánsága, hogy pontosan engedelmeskedjenek a parancsainak, nekem is adhatna egy ésszerű parancsot.
Ví dụ như lệnh phải ra đi ngay tức khắc.	Megparancsolhatná például, hogy egy percen belül keljek útra.
Hình như mọi điều kiện đều thuận lợi...	A körülmények, úgy látom, kedvezőek...
Thoạt đầu cậu hoàng tử hơi do dự, rồi chợt thở dài, bắt đầu lên đường.	A kis herceg először tétovázott, aztán egy sóhajtással mégis útra kelt.
- Ta phong ngươi làm sứ giả của ta - nhà vua vội vàng kêu lên.	- Kinevezlek nagykövetemnek!
- Ông ta có vẻ uy nghi lẫm liệt.	- kiáltott utána sietve a király.
XI	11.
- Ôi, kia, một kẻ khâm phục ta đến thăm ta!	- kiáltotta már messziről, amikor megpillantotta a kis herceget.
- Từ xa nhìn thấy cậu hoàng tử, lão khoác lác đã kêu lên thế!	- Meglátogat egy csodálóm!
Bởi vì, đối với kẻ khoác lác, ai cũng là người khâm phục mình.	Mert aki hiú, annak az összes többi ember olybá tűnik, mint a csodálója.
- Chào anh - cậu hoàng tử nói.	- Jó napot! - mondta a kis herceg.
- Anh có cái mũ ngộ quá.	- Fura kalapja van uraságodnak.
- Đội cái mũ đó để chào mà - gã khoác lác trả lời.	- Arra való, hogy megemeljem - felelte a hiú.
- Để chào khi người ta hoan hô tôi.	- Hogy viszonozzam vele az ünneplést.
Không may, chẳng ai qua đây bao giờ cả.	De sajnos, soha nem jár erre senki.
- Thế ư anh?	- Úgy?
- cậu hoàng tử không hiểu, nói.	- kérdezte a kis herceg, és egy szót sem értett az egészből.
- Bây giờ, chú em hãy vỗ tay này vào tay kia của chú xem - người khoác lác liền khuyên.	- Csapd össze a tenyeredet - javasolta neki a hiú.
Cậu hoàng tử vỗ tay này vào tay kia của mình.	A kis herceg összeütötte a két tenyerét.
Gã khoác lác cất mũ chào một cách khiêm tốn.	A hiú szerényen megemelte a kalapját.
Gã khoác lác lại chào bằng cách cất mũ.	A hiú meg újra megemelte a kalapját.
Sau năm phút làm như thế, cậu hoàng tử chán cái trò chơi buồn tẻ ấy:	Így ment ez öt percig; akkor a kis herceg elunta az egyhangú játékot.
- Thế, muốn cho chiếc mũ nó rơi tuột xuống thì phải làm thế nào ạ?	- Hát ahhoz mit kell csinálni, hogy a kalap leessék?
- Em hỏi.	- kérdezte.
Nhưng gã khoác lác không nghe thấy.	A hiú ezt egyszerűen elengedte a füle mellett.
Những người khoác lác chỉ nghe được những lời khen.	Aki hiú, az csak a dicséretet hallja meg, soha mást.
- Chú em khâm phục ta nhiều thật chứ, hả chú em?	- Valóban nagyon csodálsz engem?
-gã hỏi cậu hoàng tử.	- kérdezte a kis hercegtől.
- Khâm phục nghĩa là thế nào?	- Mit jelent az, hogy csodálni?
- Khâm phục nghĩa là thừa nhận rằng ta là người đẹp nhất, ăn mặc sang nhất, giàu có nhất và thông minh nhất trên hành tinh.	- Csodálni annyit jelent, mint elismerni az illetőről, hogy széles e bolygón ő a legszebb, a legjobban öltözött, a leggazdagabb és a legokosabb.
- Nhưng trên hành tinh của anh, chỉ có mỗi anh cơ mà?	- De hiszen te egyedül vagy a bolygódon!
- Hãy cho ta cái ta thích đó, chú em.	- Azért mégiscsak tedd meg!
Chú em dẫu sao cũng hãy cứ khâm phục ta!	Azért mégiscsak csodálj!
- Tôi khâm phục anh - cậu hoàng tử vừa nói vừa hơi nhún hai vai.	- Csodállak - mondta a kis herceg, és egy parányit megvonta a vállát.
- Nhưng anh có chịu biết là tôi khâm phục anh cái gì không?	- Csak azt nem értem, mire jó az neked!
Thế là cậu hoàng tử ra đi.	És sietve odébbállt.
"Những người lớn chắc chắn là kì quặc rồi", cậu chỉ nói đơn giản có thế trong khi đi.	"Szó, ami szó - gondolta útközben -, a fölnőttek nagyon-nagyon furcsák."
XII	12.
- Anh làm gì đây?	- kérdezte tőle.
- Ta uống rượu - người nát rượu nói, vẻ thiểu não.	- Iszom - felelte gyászos képpel az iszákos.
- Tại sao anh uống?	- Miért iszol?
- Cậu hoàng tử hỏi anh ta.	- kérdezte a kis herceg.
- Uống để quên - gã nát rượu trả lời.	- Hogy felejtsek - felelte az iszákos.
- Quên cái gì ?	- Mit?
- Cậu hoàng tử bắt đầu thấy thương, hỏi nữa.	- tudakolta a kis herceg, mert máris megsajnálta.
- Quên nỗi xấu hổ của ta - người nát rượu cúi đầu thú nhận.	- Azt, hogy szégyellem magam - felelte az iszákos és lehajtotta a fejét.
- Xấu hổ vì cái gì ?	A kis herceg szeretett volna segíteni rajta.
- Cậu hoàng tử muốn có thể giúp đỡ gã kia nên lại hỏi.	- Miért szégyelled magad?
- Xấu hổ vì uống rượu!	- kérdezte.
- Gã nát rượu thôi không nói nữa, và lần này quyết định nhốt mình trong lặng thinh.	- Mert iszom - vágta el a további beszélgetést az iszákos, és mélységes hallgatásba süllyedt.
Còn cậu hoàng tử thì ra đi, sửng sốt.	A kis herceg meghökkenve szedelőzködött.
"Những người lớn nhất định là rất, rất kì quặc" cậu tự nói thầm trong khi đi.	"Bizony, bizony - gondolta út közben -, a fölnőttek rettentően furcsák."
XIII	13.
- Chào ông, - em nói.	- Jó napot!
- Điếu thuốc lá của ông tắt ngấm rồi đấy.	- mondta a kis herceg. - Uraságodnak kialudt a cigarettája.
- Ba với hai là năm.	- Három meg kettő, az öt.
Năm với bảy mươi hai.	Öt meg hét, az tizenkettő.
Mười hai với ba là mười lăm.	Tizenkettő meg három, az tizenöt.
Chào em.	Jó napot!
Mười lăm với bảy, hăm hai.	Tizenöt meg hét, az huszonkettő.
Hăm hai với sáu, hăm tám.	Huszonkettő meg hat, az huszonnyolc.
Chẳng có thì giờ nào châm lại điếu thuốc lá.	Nem érek rá újra rágyújtani.
Hăm sáu với năm, ba mươi mốt.	Huszonhat meg öt, az harmincegy.
Ôi chà!	Hopp!
Thế là năm trăm linh một triệu sáu trăm năm hai nghìn bảy trăm ba mươi mốt.	Tehát összesen ötszázegymillió-hatszázhuszonkétezer-hétszázharmincegy.
- Năm trăm triệu cái gì vậy?	- Ötszázmillió micsoda?
- Hử?	- Mi az?
Thế mày vẫn đứng đấy à?	Még mindig itt vagy?
Năm trăm linh một triệu... ta cũng chẳng biết là triệu gì nữa.	Ötszázmillió izé... már nem is tudom... Annyi dolgom van!
Ta đứng đắn, không đùa chơi với những trò nhảm nhí đâu!	Én komoly ember vagyok, én nem fecsérlem léhaságokra az időmet!
Hai với năm, bảy...	Kettő meg öt, az hét...
- Năm trăm linh một triệu cái gì?	- Ötszázmillió micsoda?
- Cậu hoàng tử lặp lại, suốt đời cậu có bao giờ đã đặt một câu hỏi mà lại thôi không hỏi nữa đâu.	- ismételte a kis herceg, mert ha egyszer egy kérdést föltett, nem tágított tőle többé.
Lão tư sản ngửng đấu lên:	Az üzletember fölkapta a fejét.
- Từ năm mươi bốn năm nay, ở trên cái hành tinh này, ta chỉ bị quấy rầy có ba lần.	- Ötvennégy éve lakom ezen a bolygón, de eddig még csak háromszor zavartak.
Lần đầu cách đây hai mươi năm bởi một con bọ hung rơi từ đâu xuống, có mà Trời biết.	Először hu­szonkét éve egy cserebogár; isten tudja, honnét pottyant ide.
Nó gây nên một tiếng động dữ dội lắm và làm cho ta phạm đến bốn lỗi trong một bài tính cộng.	Iszonyatos zajt csapott, úgyhogy négy hibát is ejtettem a számadásomban.
Lần thứ hai cách đây mười một năm, do một cơn sổ mũi.	Másodszor tizenegy esztendeje köszvényrohamot kaptam.
Ta đứng đắn, ta ấy!	Harmadszor pedig: most!
Ta đang nói, năm trăm linh một triệu...	Szóval azt mondtam, hogy ötszázegymillió...
- Triệu gì?	- Micsoda?
Lão tư sản biết không mong được để yên!	Az üzletember látta: semmi reménye rá, hogy békén hagyják.
- Triệu những vật li ti đôi khi ta nhìn thấy trên trời ấy.	- Olyan kis apróság, amit az égen látni olykor. - Légy?
- Ruồi ư?	- Dehogy!
- Không phải, li ti mà lấp lánh cơ.	Olyan kis csillogó. - Méhek?
-Ông hử?	- Dehogy!
- Không mà... Những vật li ti vàng ánh vẫn làm cho bọn người vô tích sự mơ màng ấy.	Azok az aranyos kis izék, amin a semmittevők ábrándozni szoktak.
Ta là người đứng đắn, ta ấy!	Én azonban komoly ember vagyok!
Ta không thì giờ đâu mà mơ màng.	Nekem nincs időm semmiféle ábrándozásra.
- Hiểu rồi.	- Ahá!
- Đúng đấy.	- Az, az.
Những ngôi sao.	Csillagok.
- Thế ông làm gì với năm trăm triệu ngôi sao ấy?	- És mit csinálsz azzal az ötszázmillió csillaggal?
- Năm trăm linh một triệu sáu trăm năm mươi hai nghìn bảy trăm ba mươi mốt.	- Ötszázegymillió-hatszázhuszonkétezer-hétszázharmincegy.
Ta là người đứng đắn, ta ấy, ta rất chính xác!	Komoly ember vagyok, szeretem a pontosságot.
- Thế ông làm gì những ngôi sao ấy?	- Mit csinálsz ezekkel a csillagokkal?
- Ta làm gì à?	- Hogy mit csinálok velük?
- Vâng.	- Igen.
- Chẳng làm gì sất.	- Semmit.
Ta có chúng thôi.	Birtoklom őket.
- Ông có những ngôi sao ấy?	- Birtoklod a csillagokat?
- Phải.	- Igen.
- Nhưng tôi có trông thấy một ông vua, ông ấy cũng...	- Találkoztam egy királlyal, aki...
- Các ông vua không thể có.	- A királyok nem birtokolnak.
Các ông vua chỉ trị vì thôi.	A királyok "uralkodnak" valamin.
- Thế có những ngôi sao, việc ấy giúp gì cho ông nào?	- És mire jó neked, hogy birtoklod a csillagokat?
- Nó giúp ta giàu.	- Arra, hogy gazdag legyek.
- Giàu giúp ông được gì?	- És mire jó a gazdagságod?
- Mua những ngôi sao khác nếu có người tìm thấy nữa.	- Más csillagokat is megvenni, ha történetesen talál valaki.
"Cái lão ấy - cậu hoàng tử nghĩ thầm - lão lí sự hơi giống cái lão nát rượu". Tuy thế, cậu em vẫn còn đặt những câu hỏi khác:	"Ez körülbelül olyasformán okoskodik, mint a részegesem" - gondolta a kis herceg; de azért tovább faggatta:
- Làm thế nào người ta có được những ngôi sao?	- Hogyan lehet birtokolni a csillagokat?
- Chúng của ai nào?	- Kinek a tulajdona?
- Lão tư sản bẳn tính vặn lại.	- vágott vissza zsémbesen az üzletember.
- Không biết.	- Nem tudom.
Không của ai cả.	Senkinek.
- Thế thì chúng là của ta, bởi ta nghĩ tới chúng trước nhất.	- Akkor az enyéim, mert nekem jutott eszembe először a birtoklásuk.
- Chỉ thế là đủ ư?	- És ennyi elég is?
- Hẳn chứ.	- Természetesen.
Khi ta tìm thấy một viên kim cương không là của ai cả, thì nó là của ta.	Ha gyémántot lelsz, amelyik senkié: akkor a tiéd.
Khi ta tìm thấy một hòn đảo không phải của ai cả, thì hòn đảo ấy là của ta.	Ha szigetre bukkansz, amelyik senkié: akkor a tiéd.
Khi ta có sáng kiến gì trước người khác thì ta xin chứng chỉ cho sáng kiến đó, nó là của ta.	Ha kitalálsz valamit, ami még senki másnak nem jutott az eszébe: szabadalmaztatod, és a tiéd.
Ta, ta có được các ngôi sao kia, vì chưa hề có ai trước ta đã nghĩ chiếm hữu chúng.	Én pedig a csillagokat birtoklom, mert előttem soha senki nem gondolt rá, hogy birtokolja őket.
- Điều này thì đúng - cậu hoàng tử nói.	- Hát ez igaz - mondta a kis herceg.
- Ông dùng chúng để làm gì?	- És mit csinálsz velük?
- Ta quản lí chúng.	- Kezelem őket.
Ta đếm đi, rồi ta đếm lại, - lão tư sản nói.	Megszámolom, aztán újraszámolom - felelte az üzletember.
- Khó đấy.	- Nehéz dolog.
Nhưng ta là người đứng đắn.	De én komoly ember vagyok.
Cậu hoàng tử vẫn chưa được mãn nguyện.	A kis herceg azonban még ezzel sem érte be.
- Tôi ấy ư, nếu tôi có một cái khăn quàng, tôi quàng nó vào cổ, tôi mang nó đi.	- Nekem, ha van egy selyemsálam, a nyakam köré tekerhetem, és magammal vihetem.
Tôi ấy ư, nếu tôi có một bông hoa, tôi có thể hái bông hoa đó và mang nó đi.	Vagy ha van egy virágom, leszedhetem, és szintén magammal vihetem.
Còn ông đâu có thể hái các ngôi sao!	De te nem szedheted le a csillagaidat!
- Nghĩa là thế nào?	- Az meg mit jelent?
- Chỉ thế thôi à?	- Ennyi az egész?
- Thế đủ rồi.	- Mi kell több?
"Buồn cười thật - cậu hoàng tử nghĩ thầm.	"Érdekes - gondolta a kis herceg.
- Có vẻ thơ ca đấy.	- Sőt költői.
Nhưng mà không đứng đắn lắm đâu".	Csak éppen komolynak nem valami komoly."
Về những việc đứng đắn, cậu hoàng tử có những ý rất khác với ý các người lớn:	A kis hercegnek ugyanis egészen más fogalmai voltak a komoly dolgokról, mint a fölnőttek­nek.
- Tôi, - cậu em lại nói - tôi có một bông hoa mà hôm nào tôi cũng tưới.	- Nekem - mondta - van egy virágom, azt naponta megöntözöm.
Biết nó là thế nào!	Sosem lehet tudni.
Tôi cần thiết cho các quả núi lửa, cho bông hoa của tôi, nên tôi có chúng.	A vulkán­jaimnak is meg a virágomnak is hasznukra válik, hogy birtoklom őket.
Còn ông đâu có ích cho các ngôi sao!	Te azonban nem vagy hasznukra a csillagoknak.
Tên tư sản mở miệng nhưng chẳng biết trả lời sao cả, và cậu hoàng tử đi ra.	Az üzletember eltátotta a száját, de felelni egy mukkot sem tudott, a kis herceg pedig szedte a sátorfáját, és ment tovább.
"Những người lớn nhất định là những người hoàn toàn kì dị" - cậu em nghĩ thầm một cách đơn giản như vậy trong khi đi.	"Szó, ami szó: ezek a fölnőttek fölöttébb furcsák" - gondolta útközben.
XIV	14.
Hành tinh thứ năm rất lạ.	Az ötödik bolygó nagyon érdekes bolygó volt.
Nó bé hơn tất cả các hành tinh.	Ez volt valamennyi közt a legkisebb.
Ở đây chỉ đúng đủ chỗ cho một cây cột đèn và một người thắp đèn.	Éppen csak akkorka, hogy egy lámpa meg egy lámpagyújtogató elfért rajta.
Cậu hoàng tử nghĩ mãi không thể nào hiểu được tại sao, đâu đó trong bầu trời, trên một hành tinh không nhà cửa, không dân cư, lại có một cột đèn và một người thắp đèn để làm chi.	A kis herceg el sem tudta képzelni, mi értelme lehet valahol az égbolton egy bolygón - amelyiken se ház nincs, se embe­rek nem laknak - egy lámpának meg egy lámpagyújtogatónak.
Tuy vậy, cậu em vẫn nghĩ thầm:	Mégis azt gondolta magában:
"Có lẽ con người này là vô lí.	"Lehet, hogy ez az ember itt: merő képtelenség.
Khi ông ta thắp cây đèn của mình, như là ông ta làm sinh thêm một ngôi sao, hay một bông hoa.	Ha meggyújtja a lámpáját, mintha egy csillagot segítene világra vagy egy virágot.
Khi ông ta tắt cây đèn, ông ta giúp bông hoa hay ngôi sao ấy ngủ.	Ha eloltja a lámpáját: elaltatja vele a virágot vagy a csillagot.
Việc ấy mới thật sự là có ích vì nó đẹp".	És mert szép, valóban hasznos is."
Khi đến gần hành tinh, cậu em kính trọng chào người thắp đèn:	Amikor a bolygó közelébe ért, tisztelettel köszöntötte a lámpagyújtogatót:
- Chào ông.	- Jó napot kívánok!
Tại sao ông vừa tắt đèn đi đó?	Miért oltottad el a lámpádat?
- Điều lệnh mà - người thắp đèn trả lời.	- Mert ez a parancs - felelte a lámpagyújtogató.
- Điều lệnh là cái gì vậy?	- Hogy oltsam el a lámpámat. Jó estét!
Và ông ta thắp đèn lên lại.	Azzal meggyújtotta a lámpát.
- Nhưng tại sao ông vừa lại thắp đó?	- De hát akkor miért gyújtottad meg újra?
- Điều lệnh mà - người thắp đèn trả lời.	- Mert ez a parancs - felelte a lámpagyújtogató.
- Tôi không hiểu - cậu hoàng tử nói.	- Nem értem - jegyezte meg a kis herceg.
- Có gì mà hiểu - người thắp đèn nói.	- Nincs is mit érteni rajta - mondta a lámpagyújtogató.
- Điều lệnh là điều lệnh.	- A parancs: parancs.
Rồi ông ta tắt cây đèn.	És eloltotta a lámpát.
Và ông ta rút chiếc mùi-soa kẻ ô vuông đỏ của ông thấm mồ hôi trên trán.	Aztán egy piros kockás zsebkendővel törölgetni kezdte a homlokát.
- Nghề của ta làm đây thật kinh khủng.	- Szörnyű mesterség ez!
Xưa kia dễ chịu hơn.	Valaha régen nagyon értelmes volt.
Sáng ta tắt, chiều ta thắp.	Este meggyújtottam, reggel eloltottam a lámpát.
Phần ngày còn lại, ta nghỉ, phần đêm còn lại ta ngủ...	Aztán reggeltől estig pihenhettem, és estétől reggelig alhattam.
- Nhưng sau đó, điều lệnh thay đổi sao?	- Azóta megváltozott a parancs?
- Điều lệnh không thay đổi - người thắp đèn nói.	- A parancs nem változott - mondta a lámpagyújtogató.
- Bi kịch là chỗ này đây!	- Éppen ez a baj!
Cứ mỗi năm hành tinh này lại dần dần quay nhanh hơn, thế mà điều lệnh không thay đổi!	A bolygó évről évre gyorsabban forgott, a parancs viszont maradt a régi.
- Thế thì thế nào ?	- És?
- Cậu hoàng tử hỏi.	- kérdezte a kis herceg.
- Thế thì hiện nay nó quay mỗi phút một vòng, ta không còn lấy một giây để nghỉ ngơi.	- És most, hogy percenként fordul egyet a tengelye körül, nincs egy másodpercnyi nyugal­mam!
Mỗi phút ta phải thắp và phải tắt một lần.	Percenként oltok meg gyújtok.
- Lạ thực đấy!	- Mulatságos!
- Chẳng có gì lạ cả - người thắp đèn nói.	- Egyáltalán nem mulatságos - mondta a lámpagyújtogató.
- Ta chuyện trò với nhau thế mà đã một tháng rồi đấy.	- Tudod, mióta beszélgetünk itt egymással? Egy hónapja!
- Một tháng kia ứ?	- Egy hónapja?
- Phải.	- Úgy bizony.
Ba mươi phút.	Harminc perce.
Ba mươi ngày.	Az harminc nap!
Rồi ông thắp lại ngọn đèn.	És meggyújtotta megint a lámpáját.
Cậu hoàng tử nhìn ông ta và thấy mến yêu người thắp đèn trung thành đến thế với điều lệnh.	A kis herceg meg csak nézte, és megszerette ezt a lámpagyújtogatót, aki olyan híven ragasz­kodik a parancshoz.
Cậu em nhớ tới những cảnh mặt trời lặn mà xưa kia chính em phải đi kiếm để xem, bằng cách dịch ghế ngồi.	Eszébe jutott, hogyan kereste annak idején a napnyugtákat, hogyan húzta odébb a székét.
Em muốn giúp ông bạn thân:	Szeretett volna segíteni a barátján.
- Này ông... Tôi biết cách cho ông khi nào muốn nghỉ thì nghỉ.	- Figyelj csak ide... Tudok egy módot rá, hogy pihenhess, amikor csak akarsz.
- Bao giờ ta chả muốn - người thắp đèn nói.	- Vagyis mindig - jegyezte meg a lámpagyújtogató.
Bởi vì người ta có thể, cùng một lúc, vừa trung thành, vừa lười biếng.	Mert lehet valaki egyszerre hűséges is meg lusta is.
- Cái hành tinh của ông bé đến nỗi ông có thể bước sải ba bước là đi khắp.	- A te bolygód - folytatta a kis herceg - olyan kicsi, hogy három lépéssel körüljárhatod.
Ông chỉ có việc đi rất chậm để lúc nào cũng ở dưới ánh sáng mặt trời cả.	Ahhoz, hogy állandóan a napvilágon maradj, egyebet sem kell tenned, mint elég lassan járnod.
Khi nào ông muốn nghỉ, ông cứ bước đi... thế là ông muốn ngày dài bao nhiêu nó dài bằng ấy.	Így aztán, ha pihenni akarsz, elkezdesz járni... és a nappal addig fog tartani, ameddig kívánod.
- Nhưng cái ấy chẳng được việc gì cho ta - người thắp đèn nói.	- Ezzel nem sokra megyek - felelte a lámpagyújtogató.
- Cái ta thích nhất trên đời lại là ngủ cơ.	- Világéletemben egyet szerettem: aludni.
- Thế thì thật không may - cậu hoàng tử nói.	- Öreg hiba - mondta a kis herceg.
- Thật không may - người thắp đèn nói.	- Öreg hiba - mondta a lámpagyújtogató.
- Chúc cậu một ngày tốt lành.	- Jó napot!
Rồi ông ta tắt cây đèn.	És eloltotta a lámpáját.
- Ông ta sẽ bị tất cả những người kia khinh, ông vua, lão nói khoác, lão nát rượu, lão tư sản.	"Ezt - gondolta a kis herceg, ahogy továbbment -, ezt a többiek mind megvetnék: a király is, a hiú is, az iszákos is, az üzletember is.
Tuy thế, chỉ có ông ta là ta không thấy buồn cười.	Pedig szerintem ő az egyetlen, aki nem nevetséges.
Có lẽ bởi vì ông ta lo toan cho một cái gì khác chứ không phải là bản thân ông ta".	Talán mert mással törődik, nem saját magával."
Em thở dài, buồn tiếc, và lại nghĩ:	És sajnálkozva sóhajtott egyet.
"Chỉ ông ấy là đáng cho mình kết làm bạn thân.	"Ő az egyetlen - folytatta gondolatait -, akivel meg tudnék barátkozni.
Nhưng hành tinh của ông ấy quá bé.	Csakhogy igazán túl kicsi a bolygója.
Chẳng thể ở được hai người..."	Nem férnek el rajta ketten..."
Điều mà cậu hoàng tử không thể thú nhận với mình, ấy là em tiếc cái hành tinh thiên phúc này chủ yếu ở chỗ nó có một nghìn bốn trăm mười lần mặt trời lặn trong hai mươi bốn tiếng đồng hồ!	Magának sem merte bevallani, hogy legkivált a napi ezernégyszáznegyven napnyugtájáért sajnálja ezt az áldott bolygót.
XIX	15.
Cậu hoàng tử trèo lên một quả núi cao.	A hatodik bolygó tízszerte nagyobb volt.
Nên em dùng quả núi lửa đã tắt làm ghế ngồi.	Egy öregúr lakott rajta, és óriási könyveket írt.
- Các anh là ai ?	- Hohó!
- Các anh là ai?...	Itt egy kutató!
Các anh là ai... các anh là ai... - Tiếng vang đáp lại.	- kiáltott föl, amikor megpillantotta a kis herceget.
"Cái hành tinh buồn cười thật!"	A kis herceg leült az íróasztal szélére.
Lúc đó em nghĩ thầm.	Egy kicsit lihegett.
Ai nói câu gì cứ lặp lại câu đó.	Annyit utazott már!
- Ồ! Một nhà thám hiểm!	- Honnét jössz?
- Khách từ đâu lại?	- kérdezte tőle az öregúr.
- Tôn Ông già hỏi.	- Mi ez a nagy könyv?
- Cậu hoàng tử hỏi.	- kérdezte a kis herceg.
- Ông làm gì ở đây?	- Mit csinál itt uraságod?
- Ta là nhà địa lí - Tôn Ông già nói.	- Geográfus vagyok - felelte az öregúr.
- Nhà địa lí là người như thế nào?	- Mi az, hogy geográfus?
- Đó là một nhà bác học biết rõ đâu là sông biển, núi non, thành phố và sa mạc.	- Tudós, aki tudja, hol vannak a tengerek, folyamok, városok, hegyek és sivatagok.
- Thế thì thích thật - cậu hoàng tử nói.	- Ó, ez nagyon érdekes - mondta a kis herceg.
Rồi em đứa mắt nhìn cái hành tinh của nhà địa lí, xung quanh em.	Körülpillantott a geográfus bolygóján.
Em chưa hề được thấy một hành tinh diễm lệ dường ấy.	Ilyen fölséges bolygót még sosem látott.
- Đẹp quá, cái hành tinh của ông.	- Hát ez nagyon szép - mondta.
Có đại dương không ông?	- Óceánok is vannak rajta?
- Ta không rõ được - nhà địa lí nói.	- Azt én nem tudhatom - felelte a geográfus.
- Thế ạ!	- Ó!
(Cậu hoàng tử thất vọng) Còn núi non?	- mondta a kis herceg csalódottan.
- Ta không rõ được - nhà địa lí nói.	- És hegységek?
- Và các thành phố, và các con sông, và các bãi sa mạc?	- Azt én nem tudhatom - ismételte a geográfus.
- Ta cũng không rõ được nốt - nhà địa lí nói.	- És városok és folyamok és sivatagok?
- Ông là nhà địa lí cơ mà!	- Azt szintén nem tudhatom - felelte a geográfus.
- Đúng - nhà địa lí nói.	- De ha egyszer geográfus!
- Nhưng ta có là nhà thám hiểm đâu.	- Az igaz - felelte a földrajztudós -, viszont nem vagyok kutató.
Ta hoàn toàn thiếu các nhà thám hiểm giúp việc.	Kutatóim, sajnos, egyáltalán nincsenek.
Nhà địa lí không phải là người đi đếm các thành phố, sông biển, núi non, đại dương và sa mạc.	Hogy jönne egy földrajztudós ahhoz, hogy elinduljon, és számba vegye a városokat és folyamokat, hegységeket és tengereket, óceánokat és sivatagokat?
Nhà địa lí quan trọng hơn nhiều lắm, có thể đi nhởi được đâu.	A geográfus sokkal fontosabb ember annál, semhogy ide-oda kószáljon a világban.
Nhà địa lí không thể rời cái bàn giấy của mình được.	Ül a dolgozószobájában, és fogadja a kutatókat.
Bọn ta còn phải tiếp các nhà thám hiểm chứ.	Kikérdezi őket, és lejegyzi emlékeiket.
Và nếu thấy kỉ niệm của một ai trong bọn thám hiểm ấy mà đáng chú ý thì nhà địa lí sẽ cho điều tra về tư cách của nhà thám hiểm ấy chứ.	Aztán ha valamelyiknek az emlé­keit érdekesnek találja, vizsgálatot indíttat az illető kutató erkölcsi megbízhatóságát illetőleg.
- Tại sao phải thế ạ?	- Hát azt meg miért?
- Bởi vì một nhà thám hiểm mà nói dối sẽ gây nên những tai họa trong các sách địa lí.	- Azért, mert ha egy kutató hazudnék, annak végzetes következményei lennének a földrajz­könyvekben.
Và cả nhà thám hiểm nào uống nhiều rượu quá nữa.	Valamint annak is, ha egy kutató többet innék a kelleténél.
- Tại sao thế ạ?	- Miért?
- Cậu hoàng tử nói.	- érdeklődött tovább a kis herceg.
- Vì kẻ nát rượu cái gì cũng thấy thành đôi.	- Mert aki részeg, az duplán lát.
Nhà thám hiểm mà như thế thì đáng lẽ chỉ có một dãy núi thôi, ông ta ghi thành hai dãy.	Így a földrajztudós két hegyet tüntetne föl ott, ahol a való­ságban csak egy van.
- Thế thì tôi có biết, một người nếu mà làm thám hiểm thì là thám hiểm tồi lắm - cậu hoàng tử nói.	- Ismerek valakit - mondta a kis herceg -, akiből nagyon rossz kutató lenne.
- Có thể như thế.	- Lehet.
Vậy nên khi tư cách của nhà thám hiểm xem thấy là tốt rồi, thì người ta điều tra về sự phát minh của anh ta.	Nos, ha a kutató erkölcsisége kifogástalannak bizonyul, következik fölfedezésének a megvizsgálása.
- Người ta đi xem hay sao?	- Elmennek megnézni?
- Không, đi thì phức tạp quá.	- Nem, nem. Az túl bonyodalmas lenne.
Người ta chỉ đòi hỏi nhà thám hiểm phải cung cấp bằng chứng thôi.	Hanem fölszólítják a kutatót, hogy szolgáltasson bizonyítékokat.
Ví dụ như tìm thấy một hòn núi lớn, người ta chỉ buộc phải mang về những tảng đá to.	Ha például egy nagy hegy fölfedezéséről van szó, megkívánják tőle, hogy mutatóba szép, nagy köveket hozzon belőle.
Nhưng nhà địa lí bỗng nhiên giọng xúc động:	Hirtelen izgalom vett erőt a geográfuson.
- Nhưng mà khách là khách đến từ xa!	- De te, te nagyon messziről jöttél!
Khách hãy tả cho ta cái hành tinh của khách đi!	Írd le nekem a bolygódat!
Rồi nhà địa lí, sau khi đã mở cuốn sổ to, liền gọt bút chì.	Azzal fölütötte lajstromkönyvét, és hegyezni kezdte a ceruzáját.
Chuyện các nhà thám hiểm kể, thoạt tiên người ta ghi bằng bút chì.	A kutatók elbeszéléseit ugyanis először ceruzával jegyzik le.
Đợi cho nhà thám hiểm cung cấp bằng chứng rồi, người ta mới ghi lại bằng mực.	Megvárják, míg bizonyítékokat szolgáltat, és csak akkor következik a tintával való lejegyzés.
- Thế nào?	- Nos?
- Nhà địa lí hỏi.	- kérdezte a tudós.
- Ôi!	- Ó!
Quê tôi ấy ư, - cậu hoàng tử nói - chẳng có gì đáng chú ý lắm đâu, nó bé tí tẹo mà.	- mondta a kis herceg. - Az én bolygóm egészen apró, nincs rajta semmi különös.
Nhưng ai biết nó thế nào.	Bár sosem lehet tudni.
- Không biết thế nào - nhà địa lí nói.	- Sosem lehet tudni - mondta a geográfus.
- Tôi cũng có một bông hoa.	- Egy virágom is van.
- Bọn ta chẳng ghi nhận bông hoa - nhà địa lí nói.	- A virágokat nem jegyezzük föl - mondta a geográfus.
- Sao thế?	- Miért nem?
Nó là thứ đẹp nhất kia mà!	Hiszen az a legszebb rajta!
- Bởi vì đời hoa ngắn ngủi lắm.	- Mert a virágok múlékonyak.
- "Ngắn ngủi" nghĩa là thế nào ạ?	- Mit jelent az, hogy "múlékony"?
- Các sách địa lí - nhà địa lí nói - là quý nhất trong tất cả các loại sách.	- A földrajzkönyvek - mondta a földrajztudós - a világ legértékesebb könyvei.
Chẳng bao giờ hết thời cả.	Nem avulnak el soha.
Chẳng mấy khi một quả núi lại chuyển chỗ.	Fölöttébb ritkán fordul elő, hogy egy hegy megváltoztassa a helyét.
Chẳng mấy khi một đại dương lại cạn nước.	Fölöttébb ritka dolog az is, hogy egy óceánnak kiapadjon a vize.
Bọn ta viết nên những điều vĩnh cửu.	Mi csak örök dolgokat írunk le.
- Song những núi lửa đã tắt có thể thức dậy được - cậu hoàng tử ngắt lời.	- De a kialudt vulkán egyszer csak működni kezdhet - szólt közbe a kis herceg.
- "Ngắn ngủi" nghĩa là gì ?	- Mit jelent az, hogy "múlékony"?
- Núi lửa tắt hay núi lửa thức đối với bọn ta cũng là thế thôi - nhà địa lí nói.	- Számunkra teljességgel mindegy, hogy egy vulkán kialudt-e, vagy működik - felelte a geográfus.
- Cái ta kể tới, đó là núi.	- Nekünk csak a hegy számít.
Núi không thay đổi.	Az pedig nem változik.
- Nhưng "ngắn ngủi" nghĩa là gì?	- De mit jelent az, hogy "múlékony"?
- Cậu hoàng tử lặp lại, suốt đời cậu em đã đặt ra một câu hỏi là không chịu bỏ.	- makacskodott a kis herceg, mert ha egyszer föltett egy kérdést, nem tágított tőle soha többet.
- Nghĩa là "bị đe dọa sắp tới lúc chết" đấy.	- Azt jelenti, hogy előbb-utóbb megsemmisül.
- Cái hoa của tôi bị đe dọa sắp phải chết ư?	- Az én virágom előbb-utóbb megsemmisül?
- Hẳn thế.	- Úgy bizony.
"Đóa hoa của ta ngắn ngủi - cậu hoàng tử nghĩ thầm. - Cô bé chỉ có bốn cái gai để chống chọi ở đời!	"Múlékony a virágom - gondolta a kis herceg -, s mindössze négy tüskéje van, hogy a világtól védekezzék!
Thế mà ta để cô ấy một mình ở quê nhà!".	És én magára hagytam otthon!"
Ấy là cơn thương tiếc đầu tiên dấy lên trong lòng cậu em.	Most érzett először valami lelkifurdalás-félét.
Em lấy lại can đảm:	De nyomban összeszedte magát.
- Bây giờ ông khuyên tôi nên đi thăm đâu?	- Mit tanácsol uraságod?
- Em hỏi.	- kérdezte.
- Hành tinh Trái Đất - nhà địa lí trả lời em.	- Milyen bolygót látogassak meg! - A Földet - felelte a földrajztudós.
- Hành tinh ấy nổi tiếng lắm...	- Jó híre van...
Thế là cậu hoàng tử ra đi, vừa nghĩ đến đóa hoa của mình.	A kis herceg útra kelt, de közben egyre a virágjára gondolt.
XVI	16.
Trái Đất đâu có phải là một hành tinh xoàng!	Ez a Föld nem akármilyen bolygó ám!
Ở đây có tới một trăm mười ông vua (trong đó, hiển nhiên ta không quên kể các ông vua đen), bảy nghìn nhà địa lí, chín trăm nghìn tên tư sản, bảy triệu rưỡi gã nát rượu, ba trăm mười triệu cha khoác lác, nghĩa là vào quãng hai tỉ rưỡi người lớn.	Van rajta száztizenegy király (beleszámítva természe­tesen a néger királyokat is), hétezer geográfus, kilencszázezer üzletember, hét és fél millió részeges, háromszáztizenegymillió hiú, vagyis körülbelül kétmilliárd fölnőtt.
Để các bạn có chút ý niệm về kích thước Trái Đất, tôi phải nói với các bạn rằng trước khi tìm ra được điện, trên cả sáu châu người ta phải nuôi để dùng như nuôi dùng cả một đạo quân thật sự bốn trăm sáu mươi hai nghìn năm trăm mười một người đốt đèn.	Hogy valami fogalmunk legyen a Föld nagyságáról, gondoljuk meg, hogy az elektromosság fölfedezése előtt a hat kontinensen egész hadseregnyi lámpagyújtogatót kellett alkalmazni, szám szerint négyszázhetvenkétezer-ötszáztizenegyet.
Nhìn xa xa một chút, cảnh đốt đèn đó thật đẹp.	Kissé távolabbról nézve mindez pompás látványt nyújtott.
Các động tác của đạo quân này được điều chỉnh như trong một vở kịch ba-lê.	A hadmozdulatok éppolyan szabá­lyozottan folytak, mint egy balett mozgása egy opera színpadán.
Trước tiên là phiên những người đốt đèn nước Tân Tây Lan và nước Australia.	Kezdték az új-zélandi és az ausztráliai lámpagyújtogatók.
Sau đó, đốt đèn xong, họ đi ngủ.	Meggyújtották a lampionjaikat, aztán aludni mentek.
Tức thì đến lượt những người đốt đèn Trung Quốc và Siberia vào cuộc múa.	Utána beléptek a táncba a kínai meg a szibériai lámpagyújtogatók; majd ők is eltűntek a kulisszák mögött.
Xong, cả họ nữa, cũng biến mất trong cách hành lang.	Most került sor az oroszországi és indiai lámpagyújtogatókra.
Lại đến lượt những người đốt đèn nước Nga và nước Ấn Độ.	Utánuk az európaiakra és az afrikaiakra.
Rồi đến người Bắc Mỹ.	Aztán az észak-amerikaiakra.
Thế nhưng chẳng bao giờ họ vào ra sân khấu nhầm lẫn cả.	És sosem vétették el színre lépésük rendjét.
XVII	17.
Khi người ta muốn tỏ ra thông minh, có khi người ta phải nói dối một chút.	Ha az ember mindenáron szellemes akar lenni, megesik, hogy egy kicsit elveti a sulykot.
Tôi không thật thà lắm đâu khi kể với các bạn về những người đốt đèn.	Én sem voltam egészen szavahihető, amikor a lámpagyújtogatókról beszéltem.
Có thể có rủi ro là tôi gây một ý niệm sai lầm đối với những ai chứa quen biết hành tinh của chúng ta.	Így aztán félő, hogy hamis fogalmat adok bolygónkról azoknak, akik nem ismerik.
Loài người chiếm rất ít chỗ trên mặt đất.	Az emberek ugyanis igen-igen kevéske helyet foglalnak el a Földön.
Nếu hai tỉ con người đang sống trên mặt đất này mà đứng hơi sít lại một chút, như trong một cuộc mít-tinh vậy thì chỉ một quảng trường rộng hai mươi dặm, dài hai mươi dặm, cũng đủ chứa.	Ha a Föld kétmilliárd lakosa kissé szorosabban egymás mellé állna, olyasformán, mint például egy futballmeccsen, könnyen elférne egy húsz­ezer négyzetméternyi téren.
Trên hòn đảo bé nhất nào của Thái Bình Dương cũng có thể dồn đủ nhân loại được.	Az egész emberiséget össze lehetne zsúfolni a Csendes-óceán legparányibb kis szigetére.
Nói thế hẳn là những người lớn chẳng tin ta đâu.	A fölnőttek ezt persze nem hinnék el.
Những người lớn nghĩ là họ chiếm được nhiều chỗ lắm đấy.	Ők igen nagy helyet tulajdonítanak maguknak.
Họ thấy họ quan trọng như các cây bao-bá ấy.	Azt kép­zelik magukról, hogy tekintélyesek, akár a majomkenyérfák.
Thế nên các bạn phải khuyên họ làm bài tính đi.	Föl lehet szólítani őket: tessék, szá­moljanak.
Họ quý chữ số lắm: việc ấy họ thích đấy.	Ez tetszeni fog nekik, mert imádják a számokat.
Nhưng bạn thì bạn không cần phí nhiều thì giờ vào cái hình phạt này.	De ne vesztegessétek az időtö­ket ilyen föladatra.
Không cần.	Fölösleges.
Bạn vẫn tin tôi mà.	Inkább higgyetek nekem.
Cậu hoàng tử, một khi đáp xuống đất, rất kinh ngạc vì chẳng trông thấy người nào.	A kis herceg tehát, amint földet ért, alaposan meglepődött, hogy egy teremtett lelket sem lát.
Em đã bắt đầu sợ, cho là mình nhầm hành tinh rồi, vừa lúc một cái vòng màu ánh sáng trắng động đậy trong cát.	Már-már attól félt, elvétette a bolygót, amikor a homokban megmozdult előtte egy holdszínű gyűrű.
- Chào ban đêm - cậu hoàng tử buột miệng nói.	- Jó éjszakát!
- Chào ban đêm - con rắn nói.	- mondta a kis herceg, csak úgy találomra.
- Tôi rơi trên hành tinh nào vậy?	- Jó éjszakát!
- Cậu hoàng tử hỏi.	- felelte a kígyó.
- Trên Trái Đất, ở châu Phi - con rắn trả lời.	- Melyik bolygóra estem?
- Thế a?	- kérdezte a kis herceg.
Trên Trái Đất, không có người nào ư?	- A Földre, Afrikában - felelte a kígyó.
- Đây là sa mạc mà.	- Ó... Hát senki sincs a Földön?
Chẳng có ai trên sa mạc đâu.	- Ez itt a sivatag.
Trái Đất rộng lắm.	A sivatagban nincs senki.
- Rắn nói.	De a Föld nagy - mondta a kígyó.
Cậu hoàng tử ngồi trên một tảng đá và ngửa mặt lên trời:	A kis herceg leült egy kőre, és szemét az égre emelte.
- Có phải những ngôi sao được thắp sáng là để mỗi người một ngày kia trở về được ngôi sao của mình?	- Nem tudom - mondta -, nem azért vannak-e kivilágítva a csillagok, hogy egy napon minden­ki megtalálhassa a magáét.
Đằng ấy hãy nhìn xem cái hành tinh của tớ.	Nézd csak, az ott az én bolygóm.
Nó ở ngay bên trên ta... Nhưng nó lại xa thế!	Éppen fölöttünk... De milyen messze van!
- Nó đẹp nhỉ - rắn nói.	- Szép csillag - mondta a kígyó.
- Nhưng cậu làm gì mà tới đây?	- Mit keresel itt?
- Mình với một bông hoa, chúng mình sống không ổn thỏa lắm, - cậu hoàng tử nói.	- Nézeteltérésem támadt egy virággal - mondta a kis herceg.
- Ra thế!	- Hajaj!
- Rắn nói.	- mondta a kígyó.
Và cả hai lặng thinh.	És sokáig hallgattak.
- Loài người ở đâu?	- Hol vannak az emberek?
- Cậu hoàng tử lại nói tiếp.	- kérdezte később a kis herceg.
- Trong sa mạc hơi bơ vơ...	- Itt a sivatagban olyan egyedül van az ember.
- Ngay giữa loài người, cũng bơ vơ - rắn nói.	- Nincs kevésbé egyedül az emberek közt sem - mondta a kígyó.
Cậu hoàng tử nhìn rắn rất lâu:	A kis herceg hosszasan szemügyre vette.
- Đằng ấy là một con vật buồn cười thật, - em nói - mảnh khảnh cứ như một cái ngón tay...	- Furcsa jószág vagy, vékony, mint az ujjam...
- Nhưng tớ lại mạnh hơn ngón tay của một ông vua - Rắn nói.	- De bármilyen király ujjánál hatalmasabb - mondta a kígyó.
Cậu hoàng tử mỉm cười:	A kis herceg elmosolyodott.
- Đằng ấy không mạnh lắm đâu... đến chân, đằng ấy cũng chả có... đi đây đi đó đằng ấy cũng chả đi được.	- Nem mondhatnám, hogy nagyon hatalmas vagy, hiszen még lábad sincs... utazni se tudsz.
- Tớ có thể chở cậu đi xa hơn tàu thủy cơ - rắn nói.	- De nincs az a hajó, amelyik messzebbre bírna vinni, mint én - mondta a kígyó.
Rắn quấn quanh mắt cá của cậu hoàng tử, trông giống một chiếc vòng vàng:	Azzal, mint egy aranypánt, a kis herceg bokájára tekeredett.
- Tớ mà chạm vào kẻ nào là tớ cho hắn ta trở về ngay với đất là nơi hắn chui ra.	- Akit én megérintek, azt visszaadom a földnek, ahonnét származik - mondta.
Còn cậu, cậu trong sạch và cậu từ một ngôi sao tới...	- Te azonban tiszta vagy, és egy csillagról jöttél.
Cậu hoàng tử không nói gì.	A kis herceg nem felelt.
- Cậu làm cho tớ mủi lòng, cậu yếu đuối thế kia trên Trái Đất đá hoa cương này.	- Olyan gyönge vagy ezen a gránit Földön, hogy megesik rajtad a szívem.
- Ồ!	- Ó!
Tớ hiểu hết - cậu hoàng tử nói.	- mondta a kis herceg.
- Nhưng sao đằng ấy lúc nào cũng nói hiểm hóc thế?	- Értem, nagyon is értem. De miért beszélsz mindig rejtélyekben?
- Mọi điều hiểm hóc, tớ đều giải hết - rắn nói.	- Valamennyit megfejtem - mondta a kígyó.
Và họ lặng thinh.	És hallgattak utána tovább.
XVIII	18.
Cậu hoàng tử đi qua sa mạc và chỉ gặp có một bông hoa.	A kis herceg nekivágott a sivatagnak, de nem találkozott, csak egy virággal.
Một bông hoa chỉ ba cánh, một hoa xoàng...	Egy három­szirmú, semmi kis virággal.
- Chúc một ngày tốt lành, - cậu hoàng tử nói.	- Jó napot! - mondta a kis herceg.
- Chúc một ngày tốt lành, - bông hoa nói.	- Jó napot! - mondta a virág.
- Loài người ở đâu?	- Hol vannak az emberek?
- Cậu hoàng tử lễ phép hỏi.	- kérdezte udvariasan a kis herceg.
Bông hoa vốn một hôm có trông thấy một đoàn người đi qua:	A virág látott egyszer egy bandukoló karavánt.
- Người hả?	- Az emberek?
Có loài ấy đấy, sáu hay bảy mống, hình như thế.	Van belőlük, azt hiszem, hat vagy hét.
Em có nhìn thấy ngữ ấy mấy năm trước kia.	Évekkel ezelőtt láttam őket.
Ai biết họ ở đâu mà tìm!	De sosem lehet tudni, hol-merre vannak.
Gió thổi đi đâu, họ đi đó mà.	Viszi, sodorja őket a szél.
Họ chẳng có rễ, cái đó phiền cho họ lắm.	Nagy baj nekik, hogy nincs gyökerük.
- Từ biệt - cậu hoàng tử nói.	- Viszontlátásra - mondta a kis herceg.
- Từ biệt - hoa nói.	- Viszontlátásra - mondta a virág.
XX	19.
Và mọi con đường, đều đưa đến nơi có người.	A kialudt vulkánját zsámolynak használta.
- Chúc một ngày tốt lành - em nói.	- mondta találomra. - Jó napot!...
- Chúc một ngày tốt lành - các hoa hồng trả lời.	- Légy a barátom, olyan egyedül vagyok - mondta.
Cậu hoàng tử nhìn các hoa hồng.	- Milyen száraz, milyen hegyes, milyen sós.
- Các bạn là ai ?	- mondta.
- Kinh ngạc, em hỏi họ.	- kérdezte meghökkenten.
- Chúng em là hoa hồng - các bông hồng nói.	- Rózsák vagyunk - felelték a rózsák.
- Thế ư?	- Ó!
- Cậu hoàng tử kêu lên.	- mondta a kis herceg.
Và em liền cảm thấy rất đau khổ.	És nagyon boldogtalannak érezte magát.
Đóa hoa của em, cô ta đã có kể với em rằng cô là độc nhất vô nhị của loài hoa hồng trong vũ trụ.	Neki a virágja azt mesélte, hogy sehol a világon nincsen párja; és most ott volt előtte ötezer, szakasztott ugyanolyan, egyetlen kertben!
"Trông thấy cảnh này cô ta chắc sẽ ngượng - em nghĩ thầm... - Cô ta sẽ ho thật to và giả chết để đỡ xấu hổ.	- Iszonyatosan köhécselne, és úgy tenne, mint aki a halálán van, csak hogy nevetségessé ne váljék.
Còn mình, mình buộc làm ra vẻ chăm sóc cô ta, nếu không, cô ta chết thật mất, cốt làm cho chính mình xấu hổ mà..."	Nekem pedig úgy kellene tennem, mintha ápolnám; különben még valóban meghalna, csak hogy megszégyenítsen..."
Rồi em lại nói thầm: "Trước, mình chỉ có một bông hoa độc nhất mà mình tưởng mình giàu có, thật ra mình chỉ có một bông hoa thường thôi.	És utána még ezt gondolta: "Azt hittem, gazdag vagyok, van egy párjanincs virágom; és lám, nincs, csak egy közönséges rózsám.
XXI	21.
Chào một ngày tốt lành - con cáo nói.	- mondta a róka. - Jó napot!
- Tôi ở đây cơ mà, - giọng nói cất lên nói - dưới cây táo...	- Itt vagyok az almafa alatt - mondta a hang. - Ki vagy?
- Cậu là ai thế?	- kérdezte a kis herceg.
- Cậu hoàng tử nói - Cậu thật bảnh...	- Csinosnak csinos vagy...
- Tớ là một con cáo - con cáo nói.	- Én vagyok a róka - mondta a róka.
- Đến đây chơi với tôi - cậu hoàng tử rủ cáo.	- Gyere, játsszál velem - javasolta a kis herceg.
- Tôi buồn chết đi được...	- Olyan szomorú vagyok...
- Tớ không chơi với cậu được.	- Nem játszhatom veled - mondta a róka.
Tớ không quen.	- Nem vagyok megszelídítve.
- Thế ư?	- Ó, bocsánat!
Xin lỗi - cậu hoàng tử nói.	- mondta a kis herceg.
- "Quen" nghĩa là gì thế ?	- Te nem vagy idevalósi - mondta a róka.
- Ra cậu không phải ở đây.	- Mit keresel?
- Tớ đi tìm những con người - cậu hoàng tử nói.	- Az embereket keresem - mondta a kis herceg.
- "Quen" nghĩa là gì vậy?	- Mit jelent az, hogy "megszelídíteni"?
- Loài người - cáo nói - họ có súng, họ bắn.	- Az embereknek - mondta a róka - puskájuk van, és vadásznak.
Họ cũng nuôi gà nữa.	Azonfölül tyúkot is tenyésztenek.
Cậu đi kiếm gà, phải không?	Tyúkokat keresel?
- Không, - cậu hoàng tử nói.	- Nem - mondta a kis herceg.
- Mình kiếm bạn bè.	- Barátokat keresek.
"Quen" nghĩa là gì ?	Mit jelent az, hogy "megszelídíteni"?
- Ấy là một việc mình bỏ quên đã lâu - cáo nói.	- Olyasmi, amit nagyon is elfelejtettek - mondta a róka.
- Nó có nghĩa là "tạo nên những tình cảm ràng buộc".	- Azt jelenti: kapcsolatokat teremteni.
- Tạo nên những tình cảm ràng buộc?	- Kapcsolatokat teremteni?
- Hẳn chứ - cáo nói.	- Úgy bizony - mondta a róka.
- Đối với tớ, hiện giờ, cậu mới chỉ là một cậu bé hoàn toàn giống trăm nghìn cậu bé khác.	- Te pillanatnyilag nem vagy számomra más, mint egy ugyan­olyan kisfiú, mint a többi száz- meg százezer.
Tớ lại không có gì cần đến cậu cả.	És szükségem sincs rád.
Và cậu cũng chẳng có gì cần đến tớ.	Ahogyan neked sincs énrám.
Tớ đối với cậu chỉ là một con cáo giống như trăm ngàn con cáo.	Számodra én is csak ugyanolyan róka vagyok, mint a többi száz- meg százezer.
Nhưng, nếu cậu làm cho tớ quen dần cậu, hai đứa ta, đứa này sẽ thấy cần đứa kia.	De ha megszelídítesz, szükségünk lesz egymásra.
Đối với tớ, cậu sẽ là người duy nhất trên đời.	Egyetlen leszel számomra a világon.
Tớ đối với cậu sẽ duy nhất trên đời.	És én is egyetlen leszek a te számodra...
- Tôi bắt đầu hiểu, - cậu hoàng tử nói.	- Kezdem érteni - mondta a kis herceg.
- Có một bông hoa... tôi cho là nó đã làm cho tôi quen...	- Van egy virág... az, azt hiszem, megszelídített engem...
- Có thể, - cáo nói.	- Lehet - mondta a róka.
- Trên Trái Đất, có đủ mọi vật...	- Annyi minden megesik a Földön...
- Ôi, không phải trên Trái Đất - cậu hoàng tử nói.	- Ó, ez nem a Földön volt - mondta a kis herceg.
- Trên một hành tinh khác à?	- Egy másik bolygón?
- Phải.	- Igen.
- Trên hành tinh ấy, có kẻ đi săn không?	- Vannak azon a bolygón vadászok?
- Không.	- Nincsenek.
- Thế thì hay đấy.	- Lám, ez érdekes.
Nhưng có gà không?	Hát tyúkok?
- Không.	- Nincsenek.
- Thế thì chả có gì hoàn hảo thật!	- Semmi sem tökéletes - sóhajtott a róka.
Tất cả loài gà đều giống nhau, tất cả loài người đều giống nhau.	Egyik tyúk olyan, mint a másik; és egyik ember is olyan, mint a másik.
Vì thế, tớ hơi chán.	Így aztán meglehetősen unat­ko­zom.
Nhưng nếu cậu làm cho tớ quen thân cậu, đời tớ sẽ như chói chang ánh sáng mặt trời.	De ha megszelídítesz, megfényesednék tőle az életem.
Tớ sẽ nhận ra một bước chân khác hẳn mọi bước chân khác.	Lépések neszét hallanám, amely az összes többi lépés neszétől különböznék.
Các bước chân sẽ làm tớ chúi ngay xuống đất.	A többi lépés arra késztet, hogy a föld alá bújjak.
Nhưng bước chân của cậu lại sẽ như là âm nhạc vậy, gọi tớ từ hang chạy ra.	A tiéd, mint valami muzsika, előcsalna a lyukamból.
Và cậu hãy nhìn kìa!	Aztán nézd csak!
Cậu thấy không, ở kia, có những đồng lúa?	Látod ott azt a búza­táblát?
Tớ đâu có ăn bánh mì.	Én nem eszem kenyeret.
Lúa mì đối với tớ là vô dụng.	Nincs a búzára semmi szükségem.
Mà thế thì buồn quá.	De neked olyan szép aranyhajad van.
Tớ sẽ yêu cả tiếng gió khua trong lúa mì nữa...	És hogy szeretném a búzában a szél susogását...
Cáo nín thinh và nhìn cậu hoàng tử một lúc lâu:	A róka elhallgatott, és sokáig nézte a kis herceget.
- Tớ yêu cầu cậu... hãy làm cho tớ quen thân cậu đi - cáo nói.	- Légy szíves, szelídíts meg! - mondta.
- Tôi cũng muốn thế lắm, - cậu hoàng tử trả lời - nhưng tôi không có nhiều thì giờ.	- Kész örömest - mondta a kis herceg -, de nem nagyon érek rá.
Tôi cần tìm kiếm nhiều bạn bè và tìm hiểu nhiều sự vật.	Barátokat kell találnom, és annyi mindent meg kell ismernem!
- Người ta chỉ hiểu được những vật người ta đã thân quen - cáo nói.	- Az ember csak azt ismeri meg igazán, amit megszelídít - mondta a róka.
- Loài người bây giờ không còn đủ thì giờ hiểu cái gì hết.	- Az emberek nem érnek rá, hogy bármit is megismerjenek.
Họ mua những vật làm sẵn ở các con buôn.	Csupa kész holmit vásárolnak a kereskedőknél.
Nhưng vì không ở đâu người ta bày bán bạn hữu, nên những con người không còn bạn hữu nữa.	De mivel barátkereskedők nem léteznek, az embereknek nincsenek is barátaik.
Cậu cần bạn hữu thì cậu hãy tập tớ quen thân cậu!	Ha azt akarod, hogy barátod legyen, szelídíts meg engem.
- Phải làm như thế nào?	- Jó, jó, de hogyan?
- Cậu hoàng tử hỏi.	- kérdezte a kis herceg.
- Phải thật kiên nhẫn - cáo trả lời.	- Sok-sok türelem kell hozzá - felelte a róka.
- Ban đầu, cậu hãy ngồi hơi xa tớ một tí, thế, ở trong cỏ.	- Először leülsz szép, tisztes távolba tőlem, úgy, ott a fűben.
Tớ đứa mắt liếc nhìn cậu, nhưng cậu chẳng nói sao cả.	Én majd a szemem sarkából nézlek, te pedig nem szólsz semmit.
Tiếng nói là nguồn gốc của mọi sự hiểu nhầm.	A beszéd csak félreértések forrása.
Nhưng mỗi ngày, cậu có thể ngồi dịch lại một tí...	De minden áldott nap egy kicsit közelebb ülhetsz...
Ngày hôm sau, cậu hoàng tử trở lại.	Másnap visszajött a kis herceg.
- Tốt hơn, nên đến đúng giờ như hôm trước - cáo nói.	- Jobb lett volna, ha ugyanabban az időben jössz - mondta a róka.
- Vì chẳng hạn như bốn giờ chiều cậu đến, thế là từ ba giờ, mình đã thấy vui.	- Ha például délután négy­kor érkezel majd, én már háromkor elkezdek örülni.
Càng đến gần giờ, mình càng thấy vui.	Minél előrébb halad az idő, annál boldo­gabb leszek.
Bốn giờ mình cuống lên, mình lo lắng; và mình vụt hiểu ra cái giá của hạnh phúc!	Négykor már tele leszek izgalommal és aggodalommal; fölfedezem, milyen drága kincs a boldogság.
Nhưng nếu cậu có thể đến bất cứ lúc nào, mình không biết vào lúc nào thì nên trang điểm cho lông mình... Phải có nghi thức chứ.	De ha csak úgy, akármikor jössz, sosem fogom tudni, hány órára öltöztessem díszbe a szívemet... Szükség van bizonyos szertartásokra is.
- "Nghi thức" là cái gì?	- Mi az, hogy szertartás?
- Cậu hoàng tử hỏi.	- kérdezte a kis herceg.
- Đó cũng là một cái mình quên lâu quá - cáo nói.	- Az is olyasvalami, amit alaposan elfelejtettek - mondta a róka.
- Đó là cái gì làm cho một ngày trở nên khác những ngày khác, một giờ khác mọi giờ khác.	- Attól lesz az egyik nap más, mint a másik, az egyik óra különböző a másiktól.
Ví dụ như, ở bọn săn tớ, có một nghi thức.	Az én vadászaimnak is megvan például a maguk szertartása.
Mỗi thứ năm, họ nhảy múa với các cô gái trong làng.	Eszerint minden csütörtökön elmennek táncolni a falubeli lányokkal.
Thế thứ năm là một ngày kì diệu!	Ezért aztán a csütörtök csodálatos nap!
Hôm ấy tớ có thể rong chơi đến tận vườn nho.	Olyankor egészen a szőlőig elsétálok.
Nếu bất cứ ngày nào những kẻ đi săn ấy cũng múa nhảy được, thì ngày nào rồi cũng sẽ như ngày nào, tớ sẽ chẳng có tí ngày nghỉ nào nữa.	Ha a vadászok csak úgy akármikor táncolnának, minden nap egyforma lenne, és nekem egyáltalán nem lenne vakációm.
- Ôi chao!	- Ó!
- Cáo nói - tớ khóc lên mất.	- mondta a róka. - Sírnom kell majd.
- Lỗi tại cậu - cậu hoàng tử nói.	- Te vagy a hibás - mondta a kis herceg.
- Mình tuyệt chẳng muốn cậu khổ, cậu lại cứ muốn mình làm cho cậu thân quen mình.	- Én igazán nem akartam neked semmi rosszat.
- Đúng thế - cáo nói.	Te erősködtél, hogy szelídítselek meg.
- Kìa, cậu sắp khóc kìa!	- Igaz, igaz - mondta a róka.
- Cậu hoàng tử nói.	- Mégis sírni fogsz!
- Đúng, mình sắp khóc.	- mondta a kis herceg.
- Cáo nói.	- Igaz, igaz - mondta a róka.
- Khóc cũng chả được gì kia mà?	- Akkor semmit sem nyertél az egésszel.
- Được chứ - cáo nói.	- De nyertem - mondta a róka.
- Vẫn còn cái màu vàng kim kia của lúa mì...	- A búza színe miatt.
- Cậu hãy trở lại xem bọn hoa hồng đi.	- Majd hozzáfűzte: - Nézd meg újra a rózsákat.
Cậu sẽ rõ ra bông hoa kia của cậu là duy nhất trên đời.	Meg fogod érteni, hogy a tiéd az egyetlen a világon.
Rồi cậu hãy trở lại đây từ biệt tớ, tớ sẽ làm quà cho cậu một điều bí mật.	Aztán gyere vissza elbúcsúzni, s akkor majd ajándékul elárulok neked egy titkot.
Cậu hoàng tử đi thăm lại các hoa hồng.	A kis herceg elment, hogy újra megnézze a rózsákat.
- Các cô chẳng giống chút nào với đóa hồng của tôi, các cô chưa là gì cả - cậu em bảo các bông hồng.	- Egyáltalán nem vagytok hasonlók a rózsámhoz - mondta nekik. - Ti még nem vagytok semmi.
- Chưa ai làm cho các cô thân quen ai, các cô cũng chưa làm cho ai thân quen.	Nem szelídített meg benneteket senki, és ti sem szelídítettetek meg senkit.
Các cô giống như con cáo của tôi trước kia.	Olyanok vagytok, mint a rókám volt.
Trước kia, nó là một con cáo giống như trăm nghìn con cáo.	Ugyanolyan közönséges róka volt, mint a többi száz- meg százezer.
Song tôi đã làm nó thành bạn thân của tôi, và bây giờ nó trở nên duy nhất trên đời.	De én a barátommá tettem, és most már egyetlen az egész világon.
Và các bông hồng hết sức lúng túng.	A rózsák csak feszengtek, ő pedig folytatta:
- Các cô đẹp, nhưng các cô trống rỗng - em lại nói với họ.	- Szépek vagytok, de üresek.
- Người ta không thể chết vì các cô được.	Nem lehet meghalni értetek.
Hẳn chứ, cái bông hồng của tôi ấy, một kẻ qua đường tầm thường tưởng là nó giống các cô.	Persze egy akármilyen járókelő az én rózsámra is azt mondhatná, hogy ugyanolyan, mint ti.
Nhưng chỉ một mình nó thôi, đối với tôi, nó cũng quan trọng hơn tất cả các cô.	Holott az az igazság, hogy ő egymaga többet ér, mint ti valamennyien, mert ő az, akit öntözgettem.
Bởi vì chính nó tôi đã đặt dưới bầu kính.	Mert ő az, akire burát tettem.
Bởi vì chính nó tôi đã đem ẩn giấu sau cái chắn gió.	Mert ő az, akit szélfogó mögött óvtam.
Bởi vì chính trên thân nó mà tôi diệt các con sâu (trừ hai hay ba con dành để thành bướm).	Mert róla öldöstem le a hernyókat (kivéve azt a kettőt-hármat, a lepkék miatt).
Bởi vì chính nó, mà tôi nghe thở than, hay khoe khoang, hay đôi khi, cả nín thinh nữa.	Mert őt hallottam panaszkodni meg dicsekedni, sőt néha hall­gat­ni is.
Bởi vì nó là bông hồng của tôi.	Mert ő az én rózsám.
Rồi em trở lại chỗ con cáo:	Azzal visszament a rókához.
- Từ biệt - em nói.	- Isten veled - mondta.
- Từ biệt - cáo nói.	- Isten veled - mondta a róka.
- Đây, cái bí quyết của tớ.	- Tessék, itt a titkom.
Rất giản dị thôi: Người ta chỉ nhìn thấy thật rõ ràng bằng trái tim mình.	Nagyon egyszerű: jól csak a szívével lát az ember.
Cái chủ yếu thì mắt chẳng thể thấy.	Ami igazán lényeges, az a szemnek láthatatlan.
- Cái chủ yếu thì mắt chẳng thể thấy! - Cậu hoàng tử lặp lại, để cho nhớ.	- Ami igazán lényeges, az a szemnek láthatatlan - ismételte a kis herceg, hogy jól az emlé­ke­zetébe vésse.
- Chính là cái thời gian cậu đã tiêu phí vì bông hồng của cậu, cái thời gian ấy nó làm cho bông hồng đó trở nên quan trọng đến như thế.	- Az idő, amit a rózsádra vesztegettél: az teszi olyan fontossá a rózsádat.
- Chính là cái thời gian mà tôi đã tiêu phí cho bông hồng của tôi... - cậu hoàng tử nói, để cho nhớ.	- Az idő, amit a rózsámra vesztegettem... - ismételte a kis herceg, hogy jól az emlékezetébe vésse.
- Loài người đã quên bẵng cái sự thật này - cáo nói.	- Az emberek elfelejtették ezt az igazságot - mondta a róka.
- Nhưng cậu không nên quên.	- Neked azonban nem szabad elfelejtened.
Cậu trở nên mãi mãi có trách nhiệm về những cái gì cậu đã tập cho quen thân.	Te egyszer s mindenkorra felelős lettél azért, amit megszelídítettél.
Cậu có trách nhiệm đối với bông hồng của cậu...	Felelős vagy a rózsádért...
- Tôi có trách nhiệm đối với bông hồng của tôi... - cậu hoàng tử lặp lại, để cho nhớ.	- Felelős vagyok a rózsámért - ismételte a kis herceg, hogy jól az emlékezetébe vésse.
XXII	22.
- Chào một ngày tốt lành - cậu hoàng tử nói.	- Jó napot! - mondta a kis herceg.
- Chào một ngày tốt lành - người gác ghi nói.	- Jó napot! - mondta a váltóőr.
- Ông làm gì ở đây?	- Mit csinálsz te itt?
- Cậu hoàng tử hỏi.	- kérdezte a kis herceg.
- Ta xếp hành khách, thành từng gói nghìn người một - người gác ghi nói.	- Rostálom az utasokat, ezresével - mondta a váltóőr.
- Ta cho phóng đi, lúc bên phải, lúc về bên trái, những chuyến tàu chở các gói ấy.	- Hol jobbra küldöm a vonatokat, amik viszik őket, hol meg balra.
Rồi một con tàu nhanh sáng choang, ầm ầm như sấm dậy, bỗng làm rung lên buồng ghi.	És egy kivilágított gyorsvonat rázkódtatta meg mennydörgő robajjal a váltóházat.
- Chúng vội vã thế - cậu hoàng tử nói.	- De sürgős nekik - mondta a kis herceg.
- Chúng tìm cái gì vậy?	- Mit keresnek?
- Tìm cái gì, thì chính người lái đầu máy cũng không rõ - người gác ghi nói.	- Azt maga a mozdonyvezető se tudja - mondta a váltóőr.
Và liền gầm lên, từ hướng ngược lại, một chuyến tàu nhanh thứ hai sáng choang.	Ellenkező irányból eldübörgött egy másik kivilágított gyorsvonat.
- Chúng đã trở về rồi ư?	- Máris visszajöttek?
- Cậu hoàng tử hỏi...	- kérdezte a kis herceg.
- Không phải những toa lúc nãy đâu.	- Ezek nem ugyanazok - mondta a váltóőr.
Đổi chỗ cho nhau đấy mà.	- Ez egy ellenvonat.
- Chúng không bằng lòng chỗ chúng đứng ư?	- Nem érezték jól magukat ott, ahol voltak?
- Người ta không bao giờ bằng lòng chỗ mình đứng cả! - Người gác ghi nói.	- Az ember sosem érzi jól magát ott, ahol éppen van - mondta a váltóőr.
Và tức thì gầm lên một chuyến tàu nhanh thứ ba sáng choang.	Földübörgött egy harmadik kivilágított gyorsvonat.
- chúng đuổi theo những hành khách lúc nãy phải không?	- Ezek az első vonatnak az utasait üldözik?
- Cậu hoàng tử hỏi.	- kérdezte a kis herceg.
- Chúng chẳng đuổi theo cái gì hết - người gác ghi nói.	- Egyáltalán nem üldöznek semmit - mondta a váltóőr.
- Người ta ngủ trong đó, hay người ta ngáp.	- Alusznak odabent vagy ásítoznak.
chỉ có những đứa trẻ là dí đến bẹp mũi vào cửa kính thôi.	Csak a gyerekek nyomják az orrukat az ablaküveghez.
- Chỉ có những đứa trẻ biết là mình tìm cái gì - cậu hoàng tử nói.	- Mert csak a gyerekek tudják, hogy mit keresnek - mondta a kis herceg.
- Chúng mất thì giờ vì một con búp bê bó bằng giẻ, và con búp bê ấy trở nên quan trọng lắm, ai lấy đi của chúng, chúng sẽ khóc...	- Időt vesztegetnek egy rongybabára, amitől egyszerre nagyon fontos lesz az a rongybaba, és ha elveszik tőlük, sírnak...
- Chúng thật may mắn - người gác ghi nói.	- Könnyű nekik - mondta a váltóőr.
XXIII	23.
- Chào một ngày tốt lành - cậu hoàng tử nói.	- Jó napot! - mondta a kis herceg.
- Chào một ngày tốt lành - người lái buôn nói.	- Jó napot! - mondta a kereskedő.
Ấy là một lão buôn thuốc viên gia công, có thể làm cho đỡ khát.	Ez a kereskedő szomjúságoltó labdacsokat árult.
Chỉ một tuần uống một viên, và người ta thấy không cần phải uống nước nữa.	Aki hetente egyet bevesz, az többé nem is kíván inni.
- Tại sao ông bán thứ đó?	- Hát ezt meg minek árulod?
- Cậu hoàng tử hỏi.	- kérdezte a kis herceg.
- Đây là một sự tiết kiệm lớn về thời giờ - lão buôn nói.	- Rengeteg időt lehet megtakarítani vele - felelte a kereskedő.
- Các nhà chuyên môn đã tính toán rồi.	- A tudósok kiszámították: heti ötvenhárom percet!
- Thế người ta dùng để làm gì năm mươi ba phút ấy?	- És mit csinál az ember azzal az ötvenhárom perccel?
- Muốn làm gì thì làm...	- Amit akar...
"Mình ấy a, - cậu hoàng tử nghĩ thầm - nếu mình có năm mươi ba phút ấy để mà tiêu phí, mình sẽ rón rén tìm đến một cái vòi nước..."	"Én - gondolta a kis herceg -, ha nekem ötvenhárom fölösleges percem volna, szépen elindul­nék egy forrás felé..."
XXIV	24.
Bây giờ là ngày thứ tám từ khi máy bay của tôi bị hỏng ở giữa sa mạc, và câu chuyện này về người lái buôn, tôi vừa nghe vừa nuốt giọt nước dự trữ cuối cùng của tôi.	A defektemet követő nyolcadik napon voltunk, és úgy hallgattam a kereskedő históriáját, hogy közben vízkészletem utolsó csöppjeit kortyoltam.
- Ôi chao! - Tôi nói với cậu hoàng tử - Các kỉ niệm của em thật là đẹp, nhưng anh vẫn còn chưa chữa được máy bay của anh, anh chẳng còn tí gì để uống nữa, anh, anh cũng thèm được rón rén bước tới một vòi nước!	- Kétségkívül szépek az emlékeid - mondtam a kis hercegnek -, én azonban még mindig nem javítottam meg a gépemet, viszont innivalóm sincs több, úgyhogy magam is nagyon örülnék neki, ha szépen elindulhatnék egy forrás felé!
- Thằng bạn cáo của tôi... - em nói.	- Barátom, a róka azt mondta...
- Cậu nhỏ ạ, chồn cáo gì nữa lúc này!	- Édes kis öregem, hagyd már azt a rókát!
- Sao thế ?	- Miért?
- Ta sắp chết khát rồi kia mà...	- Mert rövidesen szomjan halunk...
Cậu em không hiểu lí lẽ viện ra của tôi, em trả lời tôi:	Nem értette az okoskodásomat, azt mondta:
- Có được một đứa bạn thân là tuyệt chứ, cho dẫu ta sắp chết cũng vẫn là tuyệt.	- Jó az embernek, ha volt egy barátja, még ha rövidesen meg is kell halnia.
Tôi, tôi rất thú vị được có một bạn thân là cáo...	Én a magam részéről nagyon örülök neki, hogy volt egy róka barátom...
"Cậu em không lường được hiểm nguy - tôi nghĩ thầm.	"Képtelen fölfogni a veszélyt - gondoltam.
- Em không hề bị đói và bị khát.	- Nem volt soha se éhes, se szomjas.
Chỉ một ít mặt trời cũng đủ cho em rồi..."	Beéri egy kis napfénnyel..."
Nhưng em nhìn tôi, trả lời đúng vào điều tôi vừa nghĩ:	Ő azonban rám nézett, úgy felelt a gondolatomra:
- Tôi cũng đang khát... ta đi tìm một cái giếng đi...	- Én is szomjas vagyok... Keressünk egy kutat...
Tôi có một cử chỉ mệt mỏi: trong mênh mang của sa mạc, đi vất vơ vất vưởng kiếm một cái giếng, thật là chuyện vô lí.	Csüggedten legyintettem: képtelen vállalkozás vaktában kutat keresni a határtalan sivatagban.
Tuy thế, chúng tôi vẫn ra đi.	De azért mégis elindultunk.
Khi chúng tôi bước, lặng thinh, không biết đã bao nhiêu giờ, bóng đêm bỗng đổ xuống và các ngôi sao bắt đầu sáng lên.	Némán vándoroltunk órákon át, aztán leszállt az éjszaka, és sorra fölragyogtak a csillagok.
Tôi nhìn thấy trời sao như tưởng mình đang mê, vì khát nên tôi có hơi sốt.	Mintha álomban láttam volna őket: egy kicsit lázas voltam a szomjúságtól.
Những lời cậu hoàng tử nói cứ nhảy múa trong trí nhớ tôi.	Emlékezetemben ott táncoltak a kis herceg szavai.
- Em cũng khát ư, em?	- Azt mondtad, te is szomjas vagy?
- Tôi hỏi em.	- kérdeztem.
Nhưng em không trả lời câu tôi hỏi.	De ő nem felelt a kérdésemre.
- Nước cũng có thể tốt lành đối với lòng ta...	- Néha a szívnek is jó a víz...
Em có vẻ nhọc.	Elfáradt.
Tôi ngồi xuống cạnh em.	Én melléje ültem.
Và sau một lát im lặng, em lại nói:	Akkor némi csönd után azt mondta:
- Các ngôi sao sở dĩ đẹp là do ở đó có một bông hoa mà ta không nhìn thấy...	- A csillagok szépek.
Tôi đáp lại "Đúng thế!"	Attól, hogy van rajtuk egy láthatatlan virág...
- Sa mạc đẹp thật, - em nói thêm.	- A sivatag is szép - tette hozzá.
Và thật thế.	Igaza volt.
Tôi vẫn yêu sa mạc.	Mindig szerettem a sivatagot.
Ta ngồi trên một đụn cát.	Az ember leül egy homokdombra.
Ta không trông thấy gì hết.	Nem lát semmit.
Ta không nghe thấy gì hết.	Nem hall semmit.
Thế nhưng, trong lặng lẽ, vẫn có một cái gì đó lóe sáng...	Valami mégis csöndesen sugárzik...
- Cái làm cho sa mạc càng thêm đẹp, - cậu hoàng tử nói - ấy là ở chỗ nó ẩn giấu một cái giếng ở một nơi nào đó...	- Az teszi széppé a sivatagot - mondta a kis herceg -, hogy valahol egy kutat rejt...
Tôi kinh ngạc vì bỗng nhiên hiểu ra cái lóe sáng huyền bí ấy của cát.	Meglepődtem, mert egyszerre megértettem a homoknak ezt a titokzatos sugárzását.
Khi còn là đứa con trai bé nhỏ, ở một ngôi nhà cổ, và có truyền thuyết là ở ngôi nhà cổ này có chôn một kho báu.	Gyerek­koromban egy régi házban laktam; a legenda szerint valahol kincs volt elásva benne.
Tất nhiên, chưa có ai biết cách tìm ra kho báu đó.	Igaz, soha senki nem jött a nyomára; meglehet, nem is kereste soha senki.
Có lẽ cũng chưa ai thử đi tìm.	Mégis elvarázsolta az egész házat.
- Phải - tôi nói với cậu hoàng tử.	Titkot rejtett valahol a szíve mélyén...
- Ngôi nhà, hay ngôi sao, hay sa mạc cái làm cho những cái ấy trở nên đẹp, cái đó không thể nhìn thấy đâu!	- Igen - mondtam a kis hercegnek -, akár egy házról van szó, akár a csillagokról, akár a sivatagról: ami széppé teszi őket, az láthatatlan.
- Em thích lắm - em nói. - Vì ông cũng đồng ý với bạn cáo của em.	- Örülök neki, hogy egy véleményen vagy a rókámmal - mondta a kis herceg.
Cậu hoàng tử chợp mắt ngủ, tôi bế em lên vòng tay tôi và lại lên đường.	És mert elaludt, a karomba vettem, és úgy folytattam utamat.
Tôi có cảm giác như đang ôm trong tay một kho báu mong manh.	Meghatottságot éreztem: mintha törékeny kincset vittem volna.
Tôi có cảm giác như trên Mặt Đất này không có gì mong manh hơn.	Sőt, mintha törékenyebb dolog egyáltalán nem is lett volna a Földön.
Nhờ ánh sáng trăng, tôi nhìn thấy vầng trán nhợt nhạt ấy, đôi mắt nhắm nghiền các lẵng tóc run rẩy trước gió, và tôi nghĩ thầm: "Cái mà ta thấy đây chỉ là cái vỏ.	Néztem a holdvilágban ezt a sápadt homlokot, ezt a csukott szempárt, ezeket a szélben meg-megrezdülő aranyfürtöket, és azt gondoltam magamban: "Amit látok, az csak a kéreg.
Cái quan trọng nhất thì không nhìn thấy được..."	Ami a legfontosabb, az láthatatlan..."
Ta phải hết sức chở che cho những ngọn đèn: một ngọn gió có thể thổi tắt được...	A lámpákra nagyon kell vigyázni: elég egy hirtelen kis szél, hogy kioltsa őket...
Và cứ bước đi như vậy, mà vào lúc tinh mơ, tôi bỗng tìm ra cái giếng.	Mentem, mentem, és hajnalban rábukkantam a kútra.
XXV	25.
- Loài người - cậu hoàng tử nói - họ chui vào trong các chuyên tàu nhanh, nhưng họ chẳng biết mình tìm kiếm cái gì.	- Az emberek - mondta a kis herceg - gyorsvonatokon zötykölődnek, de már nem tudják, mit keresnek.
Thế mà họ cứ cuống quýt lên, quay cuồng lên...	Erre elkezdenek ágálni, és csak forognak körbe-körbe...
Và em nói thêm:	Aztán még hozzátette:
- Nào có ích gì...	- Nem éri meg...
Cái giếng mà chúng tôi đi tới, nó không giống các giếng sa mạc ở Sahara.	A kút, amit találtunk, nem hasonlított a szaharai kutakhoz.
Cái giếng Sahara chỉ đơn giản là những cái lỗ đào trong cát.	A szaharai kutak egyszerűen ho­mok­ba ásott lyukak.
Còn cái giếng kia giống như giếng làng.	Ez meg olyan volt, mint egy falusi kút.
Nhưng ở đây còn có ngôi làng nào đâu.	Holott falunak nyoma sem volt, úgyhogy azt hittem, káprázik a szemem.
- Lạ thật - tôi nói với cậu hoàng tử - mọi cái đều có sẵn: cái ròng rọc, cái gầu, và sợi dây...	- Minden készen van: csiga, vödör, kötél...
Em cười, sờ sợi dây, lăn cái ròng rọc.	Nevetett, megfogta a kötelet, megmozgatta a csigát.
- Ông nghe thấy không - cậu hoàng tử nói - ta đánh thức cái giếng này, nó đang hát đấy...	- mondta a kis herceg. - Fölébresztjük a kutat, ő meg énekel...
Không muốn em gắng sức, tôi nói:	Nem akartam, hogy megerőltesse magát.
- Để anh, gầu nặng quá đối với em.	- Hagyd, majd én - mondtam. - Neked ez túl nehéz.
Chậm rãi, tôi kéo gầu lên tận thành giếng.	Lassan fölvontam a vödröt a káváig.
Tôi đặt gầu ngay ngắn trên đó.	Ráállítottam a kávára, jó szilárdan.
Trong tai tôi vẫn còn vẳng mãi tiếng reo của cái ròng rọc, và trong nước vẫn còn run rẩy, thấy ánh sáng mặt trời rung lên.	Fülemben még tartott a csiga éneke; a vödörben még remegett a víz, és benne, láttam, ott remegett a nap.
- Tôi thèm giọt nước này đây - cậu hoàng tử nói.	- Éppen erre a vízre szomjazom - mondta a kis herceg.
- Cho tôi uống...	- Adj innom...
Và tôi liền hiểu ra cậu em tìm kiếm cái gì.	Egyszerre megértettem, hogy mit keresett!
Tôi nhấc chiếc gầu lên kề môi em.	Ajkához emelte a vödröt.
Em uống, hai mắt nhắm nghiền.	Hunyt szemmel ivott.
Dịu hiền như là lễ Tết.	Olyan volt ez, mint egy ünnep.
Nó sinh ra từ cuộc đi bộ dưới trời sao, từ tiếng hát của cái ròng rọc, từ sự gắng sức của hai cánh tay tôi.	A csillagok alatti vándorlásból született, a csiga énekéből, a karom megfeszített erejéből.
Nó tốt lành cho lòng ta, như một món quà tặng vậy.	Olyan jólesett a szívnek, mint egy ajándék.
Ngày tôi còn là một cậu con trai nhỏ, ánh sáng của cây Noel, tiếng nhạc của buổi lễ nửa đêm, niềm dịu dàng của các nụ cười như vậy đó, làm nên tất cả ánh chói chang của món quà Noel mà tôi được nhận.	Mikor gyerek voltam, így aranyozta be a karácsonyi ajándékot a karácsonyfa fénye, az éjféli mise zenéje meg a mosolyok varázsa.
- Loài người nơi ông - cậu hoàng tử nói - trồng năm nghìn hoa hồng cùng trong một khu vườn... Thế mà họ chẳng thấy cái họ tìm...	- Nálatok - mondta a kis herceg - az emberek egyetlen kertben ötezer rózsát nevelnek. Mégse találják meg, amit keresnek.
- Họ chẳng tìm thấy đâu - tôi nói...	- Nem találják meg - mondtam.
- Cái họ muốn tìm lại có thể gặp thấy trong chỉ một đóa hoa hồng hoặc chỉ một ít nước thôi...	- Pedig egyetlen rózsában vagy egy korty vízben megtalálhatnák...
- Đúng thế - tôi nói.	- Minden bizonnyal - feleltem.
Và cậu hoàng tử nói thêm:	- Csakhogy a szem vak - tette hozzá a kis herceg.
- Mắt vốn mù lòa.	- A szívünkkel kell keresni.
... Tôi đã uống no.	Én is ittam.
Tôi thở được nhẹ nhàng.	Megkönnyebbültem tőle.
Vào lúc tinh mơ, cát màu mật ong.	Mikor a nap fölkel, mézszíne van a homoknak.
Tôi thấy sung sướng cả vì cái màu mật ong ấy nữa.	Most ennek a mézszínnek is örültem.
Tại sao tôi cứ phải đau khổ làm chi.	Miért is ért utol aztán a szenvedés...
- Ông phải giữ lời hứa - cậu hoàng tử bảo tôi nho nhỏ, bây giờ em đã lại ngồi xuống cạnh tôi.	- Meg kell tartanod, amit ígértél - mondta szelíden a kis herceg, és már újra ott ült mellettem.
- Lời hứa nào?	- Mit ígértem?
- Ông biết đấy... Một cái rọ mõm cho con cừu của tôi... Tôi chịu trách nhiệm về cái hoa ấy!	- Tudod... szájkosarat a bárányomnak... hiszen felelős vagyok a virágomért!
Tôi rút từ trong túi ra các bản vẽ phác của tôi.	Előszedtem a zsebemből a rajzaimat.
- Các cây bao-bá của ông, chúng hơi giống các cây bắp cải...	- mondta. - Mint a káposztafejek...
- Lại thế!	- Ugyan!
Tôi vốn tự hào biết bao khi vẽ những cây bao-bá!	Pedig olyan büszke voltam a majomkenyérfáimra!
- Con cáo của ông... hai tai nó... chúng hơi giống hai cái sừng... và lại dài quá kia!	- A rókád meg... a fülei... inkább mintha szarvak volnának... meg aztán túl nagyok is!
Và em lại cười nữa.	És megint nevetett.
- Cậu không công bằng, cậu nhỏ ơi, tôi vốn chỉ biết vẽ trăn kín với trăn bổ dọc thôi mà!	- Igazságtalan vagy, barátocskám; megmondtam, hogy nem tudok egyebet rajzolni, mint nyitott meg csukott óriáskígyót.
- Ôi, sẽ đâu vào đấy cả thôi, trẻ con chúng hiểu đấy.	- Semmi hiba - mondta. - A gyerekek megértik.
Thế là tôi dùng bút chì phác một cái rọ mõm.	Rajzoltam hát egy szájkosarat.
Và lòng tôi se lại khi tôi đưa cái rọ mõm đó cho em:	És elszorult a szívem, ahogy átnyújtottam neki.
- Em có những dự định mà tôi không được rõ...	- Neked valami titkos terved van...
Em bảo tôi:	Azt mondta:
- Ông biết không, ngày tôi rơi xuống Trái Đất... mai đã là kỉ niệm một năm...	- Tudod... holnap lesz egy éve, hogy a Földre estem...
Rồi, sau một lát im lặng, em lại nói:	Majd némi szünet után:
- Tôi rơi xuống ngay cạnh đây...	- Egészen közel ide...
Và em đỏ mặt.	Elpirult.
Và một lần nữa, chẳng hiểu tại sao, lòng tôi tủi cực lạ lắm.	S engem, magam sem tudom, miért, elfogott valami sötét szomorúság.
Tuy vậy, một câu hỏi chợt buột ra miệng tôi:	Egyszerre fölötlött bennem egy kérdés:
- Thế ra không phải ngẫu nhiên mà buổi sáng ấy, tôi gặp em, cách đây tám ngày, em dạo chơi lang thang một mình một nghìn dặm cách mọi vùng có người ở?	- Akkor hát egy hete reggel, amikor megismertelek, nem csak úgy véletlenül kószáltál itt, egyszál-egyedül, ezer mérföldnyire minden lakott helytől?
Bây giờ em trở về nơi em rơi xuống sao?	Oda akartál visszamenni, ahová leestél?
Cậu hoàng tử lại đỏ mặt.	A kis herceg újra elpirult.
Và tôi nói, ngập ngừng:	Én pedig habozva hozzátettem:
- Vì ngày kỉ niệm, có lẽ thế chăng?...	- Csak nem az évforduló miatt?
Cậu hoàng tử đỏ mặt nữa.	A kis herceg még jobban elpirult.
Em không bao giờ trả lời các câu hỏi, nhưng khi người ta đỏ mặt, như thế có nghĩa là "phải", phải không?	Felelni nem felelt a kérdéseimre; de ha valaki elpirul, az ugye azt jelenti, hogy "igen".
- Ôi! - Tôi nói.	- Ó - mondtam neki -, attól félek...
- Tôi sợ...	Azt felelte:
- Bây giờ ông phải làm việc thôi.	- Neked most dolgoznod kell.
Tôi đợi ông ở đây.	Vissza kell menned a gépedhez.
Chiều mai ông hãy đến.	Itt várlak majd, gyere vissza holnap este...
Song tôi không yên tâm.	Én azonban nyugtalan maradtam.
Tôi nhớ chuyện con cáo.	Eszembe jutott a róka.
Khi ta để ai làm cho ta thân quen, thế nào cũng có nguy cơ là ta có thể khóc một tí.	Aki hagyja, hogy megszelídítsék, az a sírás kockázatát is vállalja vele...
XXVI	26.
Cạnh cái giếng có một bức thành đá cổ đổ nát.	A kút mellett romladozó kőfal húzódott.
Khi ở chỗ sửa máy trở lại chiều hôm sau, từ xa, tôi đã thấy cậu hoàng tử của tôi ngồi vắt vẻo bên trên bức thành đó.	Mikor másnap este, munkám után visszajöttem, már messziről észrevettem a kis herceget: lábát lógatva fönt ült a fal tetején.
Và tôi nghe em nói:	És hallottam, hogy beszél valakivel.
- Thế đằng ấy không nhớ ư?	- Hát nem emlékszel rá?
Một giọng nói khác có lẽ trả lời em, vì nghe tiếng em đối đáp:	Erre egy másik hang felelhetett neki valamit, mert ő megint erősködni kezdett:
- Đúng chứ!	- Igen, igen!
Ngày thì đúng, nhưng không phải chỗ này...	A napja ma van, de a helye nem egészen ez...
Tôi bước tiếp đến chỗ bức thành.	Mentem tovább a fal felé.
Tôi không nhìn thấy, cũng vẫn chẳng nghe thấy ai.	Kívüle még mindig nem láttam, nem hallottam senkit.
Thế nhưng cậu hoàng tử lại đáp nữa:	Ő azonban tovább vitatkozott:
- Hẳn thế.	- ...Úgy bizony.
Đằng ấy hãy xem nơi nào bắt đầu có dấu chân của tớ trên cát.	Nézd csak meg, hol kezdődik a nyomom a homokban.
Đằng ấy cứ đợi tớ ở đây.	És csak várj rám.
Đêm nay tớ sẽ có mặt đấy.	Ma éjszaka ott leszek.
Tôi chỉ cách bức thành có hai mươi mét và tôi vẫn chẳng nhìn thấy gì.	Már csak húszméternyire voltam a faltól, de még most sem láttam semmit.
Cậu hoàng tử, sau một lát im lặng, lại nói:	A kis herceg egy darabig hallgatott, aztán azt kérdezte:
- Nọc đằng ấy tốt đấy chứ?	- Jó mérged van?
Đằng ấy chắc là chẳng làm tớ khổ lâu chứ?	Biztos vagy benne, hogy nem fogok sokáig szenvedni?
Tôi dừng lại, trái tim se thắt, nhưng vẫn không hiểu.	Megtorpantam, elszorult a szívem, de még mindig nem értettem a dolgot.
- Thôi, bây giờ đằng ấy đi đi - em nói.	- Most pedig menj el - mondta a kis herceg.
- Tớ muốn bước trở xuống.	- Le akarok jönni innét!
Tức thì chính tôi cúi nhìn xuống chân thành, và tôi vội nhảy vọt lên.	Erre magam is a fal tövébe néztem, hirtelen hőköléssel.
Nó đó, ngỏng đầu lên phía cậu hoàng tử, một giống rắn vàng có thể diệt ta trong ba mươi giây đồng hồ.	Mert egy kígyó ágaskodott ott a kis herceg felé, egyike azoknak a sárga kígyóknak, amelyek harminc másodperc alatt végeznek az emberrel.
Vừa lục túi tìm khẩu súng ngắn, tôi vừa bước sải, nhưng nghe tiếng động của tôi, con rắn liền chuồi trong cát, như thể một dòng nước cặn sót, và chẳng lấy gì làm vội vàng, nó luồn lách giữa các tảng đá, tiếng nó bò nghe hơi lanh canh như tiếng kim khí.	Kezemet a zsebembe mélyesztettem, hogy előrántsam a revolveremet, és futni kezdtem feléjük; lépteim zajára azonban a kígyó puhán visszaernyedt a homokba, olyas­formán, mint egy szökőkút elhaló sugara, és sietség nélkül, fémes kis nesszel eltűnt a kövek közt.
- Lại thế nữa!	- Hát ez meg mi volt?
Bây giờ em lại đi chuyện trò với rắn!	Most már kígyókkal társalkodol?
Tôi tháo chiếc khăn vàng kim bao giờ em cũng quàng ở cổ.	Kibontottam aranyszínű sálját, amit örökké a nyaka köré tekerve hordott.
Tôi đã dấp nước vào hai thái dương em và cho em uống.	Megnedvesítettem a halántékát, és itattam vele pár kortyot.
Và bây giờ, chính tôi không dám hỏi em điều gì.	De kérdezni már nem mertem tőle semmit.
Em nhìn tôi nghiêm nghị và đưa hai tay ôm cổ tôi.	Komolyan nézett rám, karját a nyakamba fonta.
- Tôi sung sướng lắm, vì biết ông đã rõ máy bay của ông đang thiếu cái gì.	- Örülök neki, hogy sikerült megjavítanod a gépedet.
Rồi ông sẽ trở về được nhà ông...	Most aztán hazatérhetsz...
- Làm thế nào em biết thế?	- Honnan tudod?
Đúng là lúc ấy, tôi vừa định báo cho em biết, tưởng tuyệt vọng rồi hóa ra tôi đã sửa được máy.	Éppen azt akartam elújságolni neki, hogy minden várakozás ellenére mégiscsak zöld ágra vergődtem a munkámmal.
- Tôi cũng như ông, hôm nay tôi về nhà tôi...	Nem felelt a kérdésemre.
Rồi, giọng ngậm ngùi:	Aztán azt mondta:
- Nhà tôi ở xa hơn nhiều... đi khó hơn nhiều...	- Én is hazamegyek ma... - És szomorkásan hozzátette: - De az sokkal messzebb van... és sokkal nehezebb...
Tôi có cảm giác vừa xảy ra một việc gì dị thường.	Éreztem, hogy valami rendkívüli dolog történik.
Tôi siết chặt em trong vòng tay như thường người ta siết chặt một em bé, nhưng tôi vẫn có cảm giác em đang chuồi thẳng đứng xuống một vực thẳm nào đó, và tôi không làm cách nào giữ em lại được...	Úgy szorítottam a karomba, mint egy gyereket; közben mégis olyan volt, mintha függőlegesen elfolynék valami szakadékba, és én mit sem tehetek, hogy visszatartsam...
Mắt em nghiêm nghị, đăm đắm nhìn về một nơi nào xa lắm.	Tekintete komoly volt, és valahol a messzeségben járt.
- Tôi đã được ông cho con cừu.	- Mim van?
Tôi lại có chiếc rọ mõm...	Meg a szájkosár...
Và em mỉm cười, có vẻ hơi buồn.	Szomorúan elmosolyodott.
Tôi đợi rất lâu.	Vártam, hosszan, sokáig.
Tôi có cảm giác là em dần dà ấm lên:	Éreztem, hogy lassacskán átmelegszik.
- Cậu em ạ, cậu có hơi sợ...	- Kedves kis barátom, te féltél...
Em có sợ, đúng rồi!	Igen, félt, de még mennyire félt!
Nhưng em cười khẽ:	Hanem azért szelíden fölnevetett.
Và tôi hiểu rằng ấy là ý nghĩ rồi đây không bao giờ còn nghe thấy tiếng cười này, đó là điều tôi không chịu được.	És tűrhetetlennek éreztem már a puszta gondolatát is, hogy nem hallom többet a nevetését.
Tiếng cười ấy của em đỗi với tôi giống như một cái giếng nước trong sa mạc.	Hiszen olyan volt számomra, mint forrás a sivatagban.
- Cậu em ạ, tôi còn muốn được nghe em cười...	- Kis barátom, hallani akarom még a nevetésedet...
Nhưng em bảo tôi:	De ő azt mondta:
- Đêm nay, vừa đúng một năm.	- Ma éjszaka éppen egy éve.
Ngôi sao của tôi sẽ lại ở đúng bên trên chỗ tôi rơi xuống năm ngoái...	Ma éjjel a csillagom pontosan a fölött a hely fölött lesz, ahol egy esztendeje földre hullottam...
- Cậu em ạ, chuyện rắn, chuyện hẹn gặp, chuyện ngôi sao này, có phải chỉ là mộng dữ không?	- Kedves kis barátom, ugye, ez az egész csak rossz álom, ez a kígyóhistória, ez a találkozó, ez a csillagmese...
Nhưng em không trả lời câu tôi hỏi.	Erre a kérdésre azonban nem válaszolt.
Em bảo tôi:	Azt mondta:
- Cái gì mà quan trọng, cái đó không thấy được đâu...	- Ami fontos, azt nem lehet látni...
- Đúng thế...	- Persze...
- Giống như bông hoa của tôi.	- A virágokkal is így van.
Khi ông yêu một bông hoa, mà bông hoa ấy lại ở trên một ngôi sao, ban đêm, khi ông nhìn trời, ông thấy lòng dịu dàng lắm.	Ha szeretsz egy virágot, valahol egy csillagon, jólesik éjszaka fölnézned az égre.
Toàn thể các ngôi sao đều nở hoa.	Minden csillagon van egy virág.
- Đúng thế...	- Persze...
- Nước cũng thế.	- És a vízzel is így van.
- Đúng thế...	- Persze...
- Đêm ông sẽ nhìn sao.	- Éjszaka majd fölnézel a csillagokra.
Nhà tôi bé tí teo nên tôi không thể chỉ cho ông đâu là ngôi sao của tôi được.	Az enyém sokkal kisebb, semhogy megmutathatnám, hol van.
Thế có lẽ lại tốt hơn.	De jobb is így.
Tất cả các ngôi sao sẽ là bạn thân ông.	Így aztán minden csillagot szívesen nézel majd...
Em lại cười lên nữa.	Azonfölül egy ajándékot is adok neked.
Em ơi, em ơi, tôi thích nghe em cười như thế này biết mấy!	- Ó, kedves kis barátom, hogy szeretem hallani a nevetésedet!
- Đúng đó là món quà tôi biếu ông... như nước vậy mà...	- Éppen ez lesz az ajándékom... olyasforma, mint a víz...
- Em muốn nói sao?	- Mit akarsz ezzel mondani?
- Mọi người có những ngôi sao, không của ai giống của ai.	- Az embereknek nem ugyanazt jelentik a csillagaik.
Đối với một số, ưa thích đi xa, các ngôi sao là những kẻ dẫn đường.	Akik úton járnak, azoknak vezetőül szolgálnak a csillagok.
Đối với số khác, chúng chỉ là những đốm sáng nhỏ.	Másoknak nem egyebek csöppnyi kis fényeknél.
Đối với những người khác nữa, họ là nhà bác học, chúng là những bài tính.	Ismét mások, a tudó­sok számára problémák.
Đối với lão tư sản tôi kể ấy, chúng vốn là vàng.	Az üzletemberem szemében aranyból voltak.
Nhưng tất cả các loại ngôi sao đều đã tắt.	A csillagok viszont mind-mind hallgatnak.
Còn ông, ông sẽ có những ngôi sao trước nay không ai có...	De neked olyan csillagaid lesznek, amilyenek senki másnak...
- Em muốn nói sao?	- Hogyhogy?
- Rồi đây, ban đêm, khi ông nhìn trời, bởi vì ở một trong những ngôi sao đó có tôi, bởi vì trong một ngôi sao đó có tôi cười, nên ông sẽ tưởng chừng tất cả các ngôi sao đều cười.	- Mert én ott lakom majd valamelyiken, és ott nevetek majd valamelyiken: ha éjszakánként fölnézel az égre, olyan lesz számodra, mintha minden csillag nevetne.
Ông, ông sẽ có được những ngôi sao biết cười!	Neked, egyedül neked, olyan csillagaid lesznek, amik nevetni tudnak!
Rồi em lại cười nữa.	És megint nevetett.
- Và khi ông đã nguôi rồi (bao giờ người ta chả nguôi đi), ông sẽ bằng lòng đã từng được quen biết tôi.	- S ha majd megvigasztalódtál (mert végül is mindig megvigasztalódik az ember), örülni fogsz neki, hogy megismerkedtél velem.
Ông mãi mãi là bạn thân tôi.	Mindig is a barátom leszel.
Ông sẽ thèm được cười với tôi.	És szívesen fogsz együtt nevetni velem.
Rồi đôi khi ông mở cửa sổ nhà ông, tự nhiên thích mở, thế thôi... Các bạn hữu của ông sẽ lấy làm lạ, thấy ông vừa nhìn trời vừa cười.	És néha kinyitod majd az ablakodat, csak úgy, kedvtelésből... És a barátaid nagyot néznek majd, ha látják, hogy nevetsz, amikor fölnézel az égre.
Tôi đùa ghẹo ông, thế đấy!	Szép kis tréfa lesz...
Rồi em lại cười nữa.	És nevetett újra.
- Như là đáng lẽ phải cho ông những ngôi sao, tôi lại đứa cho ông hàng đống những cái chuông nhỏ biết cười...	- Mintha a csillagok helyett egy csomó kacagni tudó csengettyűt kaptál volna tőlem...
Rồi em lại cười nữa.	És újból nevetett.
Và bỗng trở lại nghiêm nghị:	De aztán elkomolyodott.
- Đêm nay... ông ạ... ông đừng đến.	- Ma éjszaka... tudod... ne gyere el.
- Tôi sẽ không rời em đâu.	- Nem hagylak magadra.
- Hình như tôi ốm... Tôi hơi có vẻ sắp chết.	- Olyan leszek majd, mintha valami bajom volna... egy kicsit olyan, mintha meghalnék.
Thế thôi mà!	Úgy bizony.
Ông đừng đến nhìn trông cảnh đó, không cần đâu...	Ne gyere el, semmi szükség rá, hogy végignézd... Nem éri meg...
- Tôi sẽ không rời em.	- Nem hagylak magadra.
Nhưng em có vẻ lo lắng.	Ő szemlátomást gondterhelt volt.
- Tôi nói với ông cái này... cũng tại con rắn đấy.	- Azért mondom... a kígyó miatt.
Chúng lại có thể vì thích mà cắn...	Puszta kedvtelésből is marnak...
- Tôi sẽ không rời em.	- Nem hagylak magadra.
- Song đúng là đến lần cắn thứ hai thì chúng chẳng còn nọc nữa đâu!...	- Igaz, második marásra már nem marad mérgük...
Đêm ấy, khi em lên đường, tôi không nhìn thấy.	Azon az éjszakán észre sem vettem, mikor kelt útra.
Em đã lặng lẽ trốn đi.	Nesztelenül megszökött.
Khi tôi theo kịp em, em bước nhanh, cả quyết.	Mikor végre utolértem, elszántan, gyors léptekkel menetelt.
Em chỉ nói với tôi:	Csak ennyit mondott:
- Ôi, ông đấy ư?	- Ó, hát itt vagy...
Rồi em cầm tay tôi.	És kézen fogott.
Nhưng em lại dằn vặt nữa:	De még mindig bántotta valami.
- Ông không đúng, ông ạ. Ông chỉ tổ làm cho ông khổ.	- Nem jól tetted.
Còn tôi, tôi nín thinh.	Én csak hallgattam.
- Ông biết không.	- Ugye, érted?
Xa lắm!	Nagyon messze van.
Tôi không lê cái thân xác này về được.	Nem vihetem magammal ezt a testet.
Nặng lắm!	Túl nehéz.
Tôi, tôi nín thinh.	Hallgattam.
- Nhưng nó sẽ cũng chỉ như một cái vỏ già lột ra vứt bỏ.	- Olyan lesz, mint egy levetett, régi kéreg.
Những cái vỏ già thì có gì đáng buồn...	Mért volna szomorú egy levetett kéreg?...
Tôi, tôi nín thinh.	Hallgattam.
Em có hơi nản.	Egy kicsit elbátortalanodott.
Nhưng em có vẻ lại gắng sức một lần nữa:	De aztán újra összeszedte magát.
- Sẽ hay lắm chứ, ông?	- Tudod, milyen jó lesz?
Tôi cũng sẽ nhìn các ngôi sao.	Én is nézem majd a csillagokat.
Tất cả các ngôi sao sẽ là những cái giếng với một cái ròng rọc cót két.	Minden egyes csillag kút lesz, rozsdás csigával.
Tôi, tôi nín thinh.	Hallgattam.
- Sẽ thích biết bao nhiêu!	- Olyan mulatságos lesz!
Ông sẽ có năm trăm triệu chiếc chuông nhỏ, còn tôi, năm trăm triệu vòi nước uống...	Neked ötszázmillió csengettyűd lesz, nekem ötszázmillió forrásom...
- Chỗ này.	- Helyben vagyunk.
Ông để tôi bước tới một bước, một mình tôi thôi.	Most hadd menjek pár lépést egyedül.
Em lại nói nữa:	Aztán azt mondta:
- Ông biết đấy... Bông hoa của tôi... Tôi chịu trách nhiệm về cô ấy!	- Tudod... a virágom... felelős vagyok érte.
Cô ấy yếu đuối nhường ấy!	Hiszen olyan gyönge!
Cô ấy thơ ngây nhường ấy!	És olyan gyanútlan.
Để tự bảo vệ trên đời, cô chỉ có bốn cái gai có nghĩa lí gì đâu...	Egyebe sincs, mint négy semmi kis tövise, hogy a világtól védekezzék...
Tôi ngồi xuống vì không thể đứng được nữa.	Leültem én is, mert nem bírtam tovább állva maradni.
- Chuyện chỉ có thế thôi mà!	- Ennyi az egész.
Em lưỡng lự một chút, rồi ngửng lên.	Egy kicsit még tétovázott, aztán fölállt.
Em bước một bước.	Lépett egyet.
Chỗ mắt cá của em, chỉ thấy có một thoáng chớp màu vàng.	Csak ennyi volt: egy sárga villanás a bokájánál.
Em đứng một lúc không động đậy.	Egy pillanatig mozdulatlanul állt.
Em không khóc.	Nem kiáltott.
Em bỗng ngả xuống từ từ, như một cái cây đổ.	Szelíden dőlt el, ahogyan a fák.
Và giờ đây, đúng vậy, sáu năm đã trôi qua... Tôi vẫn chưa kể câu chuyện này.	S én még soha senkinek sem meséltem el ezt a történetet.
Những bạn bè gặp lại tôi... rất lấy làm thích thấy tôi còn sống mà về.	Bajtársaim, mikor viszontláttak, örültek, hogy élve látnak.
Tôi buồn, và tôi nói với họ: "Mình mệt đấy thôi!"...	Én szomorú voltam, de azt mond­tam: "Azért, mert nagyon fáradt vagyok..."
Bây giờ tôi đã nguôi nguôi.	Most már egy kicsit megvigasztalódtam.
Nghĩa là... không hẳn là như thế.	Azaz... mégsem egészen.
Nhưng tôi biết cậu em đã trở về cái hành tinh của mình, vì, tinh mơ hôm sau, tôi đã không còn thấy thân xác em.	De tudom, hogy visszatért a bolygójára, mert mikor fölkelt a nap, nem találtam ott a testét.
Thân xác ấy nào có nặng gì cho cam... Và bây giờ, ban đêm, tôi thích lắng nghe các ngôi sao.	Annyira mégsem volt nehéz... És szeretem a csillagokat hallgatni éjszakánként.
Chúng như năm trăm triệu cái chuông nhỏ...	Mintha ötszázmillió csengettyű volna...
Nhưng có xảy ra một điều không thường.	De lám csak, van itt egy rendkívüli kérdés!
Chiếc rọ mõm mà tôi đã vẽ cho cậu hoàng tử, tôi đã quên vẽ thêm cái đai da!	A szájkosárról, amit a kis hercegnek rajzoltam, lefelejtettem a bőrszíjat!
Thế em làm thế nào buộc rọ ấy vào cho con cừu được?	Sose tudhatja fölcsatolni a bárányára.
Vậy nên tôi lại tự hỏi: "Việc gì đã diễn ra trên hành tinh của em?	S én azt kérdezem magamban: "Mi történt a bolygón?
Hẳn là con cừu đã ăn mất bông hoa rồi, có lẽ thế..."	Lehet, hogy a bárány megette a virágot..."
Lúc khác, tôi lại nghĩ: "Tin chắc là không!	Egyszer azt gondolom: "Nem, semmiképpen sem!
Cậu hoàng tử đêm nào cũng ẩn giấu bông hoa của mình dưới cái bầu kính, và em canh chừng cẩn thận con cừu..." Nghĩ thế, tôi thấy tôi sung sướng.	A kis herceg mindig üvegbura alá teszi éjszakára a virágját, és éberen vigyáz a bárányára..." Ilyenkor boldog vagyok, és a csillagok mind kedvesen nevetnek.
Và tất cả các ngôi sao đều cười lên khe khẽ.	Másszor meg ezt gondolom: "Az ember olykor-olykor figyelmetlen, és máris kész a baj!
Một tối nào đó, em quên bẵng cái bầu kính, hoặc con cừu lẻn ra se sẽ trong đêm..." Nghĩ thế, các tiếng chuông liền biến hết thành nước mắt!...	Egy este elfelejti föltenni az üvegburát, vagy éjszaka nesztelenül kiszökik a bárány..." És ilyenkor a csengettyűk mind csupa könnyé változnak.
Đối với các bạn là người cũng yêu cậu hoàng tử nhỏ, cũng như đối với tôi, không gì trên vũ trụ này còn giống nguyên như trước, nếu đâu đây, không biết là nơi nào, có một con cừu mà chúng ta không biết, nó có ăn hay đã không ăn một bông hồng...	Mert ti szeretitek a kis herceget, nektek se mindegy, mint ahogy nem mind­egy nekem sem, hogy valahol a mindenségben, ki tudja, hol, ki tudja, merre, egy bárány, akit nem is ismerünk, lelegelt-e egy rózsát, vagy sem...
Bạn hãy nhìn trời.	Nézzetek föl az égre.
Bạn hãy tự hỏi: Con cừu đã ăn hay không ăn bông hồng nhỉ?	És tegyétek föl a kérdést: megette vagy nem ette meg a virágot a bárány?
Và bạn sẽ thấy là mọi vật liền đổi khác.	S aszerint, igen vagy nem, meglátjátok, egyszerre megváltozik minden...
Và chẳng một người lớn nào có lúc hiểu được rằng điều đó nó quan trọng đến nhường ấy đâu!	És soha, egyetlen fölnőtt sem fogja megérteni, hogy ez milyen rettentően fontos!
Cảnh này đối với tôi là cảnh đẹp nhất và buồn nhất trên đời.	Számomra ez itt a világ legszebb és legszomorúbb tája.
Cũng là cái cảnh ở trang trước thôi, nhưng tôi vẽ lại một lần nữa để chỉ cho các bạn được thấy kĩ.	Ugyanaz a táj, mint az előző lapon, de még egyszer lerajzoltam, hogy jól lássátok.
Chính nơi này cậu hoàng tử đã hiện ra trên mặt đất, rồi biến mất.	Itt jelent meg a Földön, s aztán itt tűnt el róla a kis herceg.
Các bạn hãy nhìn thật chăm chú cảnh ấy để tin được, chắc rồi mình có thể nhận ra nếu một mai bạn có đi Châu Phi, có qua sa mạc.	Tanulmányozzátok figyelmesen, hogy biztosan ráismerjetek, ha egyszer Afrikában utaztok, a sivatagban.
Và, nếu một mai mà bạn có qua nơi đó, tôi khẩn cầu bạn, xin chớ vội vàng, hãy đợi lại một chút ngay dưới ngôi sao!	S ha netalán arra visz az utatok, kérve kérlek, ne siessetek, időzzetek el egy kicsit ott, pontosan a csillag alatt.
Nếu có một em bé đi lại phía bạn, nếu em ấy cười, nếu em ấy có mái tóc vàng, nếu ta hỏi em mà em chẳng trả lời, bạn sẽ đoán được ngay em bé đó là ai.	Ha akkor egy gyerek lép hozzátok, és nevet, és aranyhaja van, és nem felel, ha kérdezik: nyilván kitaláljátok, ki az.
